啊: aakk
阿: eeek
埃: aitu
挨: aifu
哎: aikx
唉: aiku
哀: aiwy
皑: aibj
癌: aibe
蔼: aicv
矮: aiun
艾: yicx
碍: aiuc
爱: aip
隘: aiem
鞍: angn
氨: anqn
安: anbn
俺: anrd
按: anfn
暗: anoo
岸: aneg
胺: anon
案: anbm
肮: ahoj
昂: ahoe
盎: ahym
凹: wala
敖: aofw
熬: aofh
翱: aobx
袄: aopy
傲: aorw
奥: aopd
懊: aoxd
澳: aodd
芭: bacb
捌: bafd
扒: pafb
叭: bakb
吧: bakb
笆: bavb
八: bapn
疤: babb
巴: bavv
拔: bafd
跋: bazd
靶: bagb
把: bafb
耙: balb
坝: batr
霸: bayo
罢: piss
爸: babb
白: bdpo
柏: bomb
百: bdab
摆: bdfs
佰: bdrb
败: bdkw
拜: bduf
稗: bdhu
斑: bjww
班: bjww
搬: bjfy
扳: bjfy
般: bjvy
颁: bjbr
板: bjmy
版: bjpy
扮: bjfd
拌: pjfb
伴: bjrb
瓣: bjlu
半: bjdl
办: bjld
绊: bjsb
邦: bhfe
帮: bhfj
梆: bhme
榜: bhmf
膀: phof
绑: bhse
棒: bhml
磅: phuf
蚌: bhif
镑: bhjf
傍: bhrf
谤: bhyf
苞: bccs
胞: bcos
包: bcbs
褒: bcwy
剥: boed
薄: bocc
雹: bcys
保: bcrm
堡: purt
饱: bcus
宝: bcby
抱: bcfs
报: bcfy
暴: bcou
豹: bcvu
鲍: bcas
爆: bchu
杯: bwmb
碑: bwuu
悲: bwfx
卑: bwpu
北: bwlb
辈: bwfi
背: bwlo
贝: bwkr
钡: bwjr
倍: bwrk
狈: bwqr
备: bwwt
惫: bwwx
焙: bwhk
被: pipy
奔: bfdc
苯: bfcb
本: bfa
笨: bfvb
崩: bgeo
绷: bgso
甭: bgby
泵: bguu
蹦: bgzo
迸: bgzk
逼: bizt
鼻: bizl
比: bibb
鄙: bike
笔: bivm
彼: biiy
碧: biwu
蓖: bicb
蔽: bicw
毕: bibu
毙: bibb
毖: bibb
币: bipj
庇: bigb
痹: bibl
闭: bimc
敝: bidw
弊: bidc
必: bidd
辟: biuu
壁: biut
臂: bwuo
避: bizu
陛: biet
鞭: bmgg
边: bmzl
编: bmsc
贬: bmkf
扁: pmhc
便: pmrg
变: bmwy
卞: bmdx
辨: bmlu
辩: bmlu
辫: bmlu
遍: bmzc
标: bnmx
彪: bnhp
膘: bnox
表: bnfy
鳖: bpda
憋: bpdx
别: bpk
瘪: bpbb
彬: bbmp
斌: bbwv
濒: bbdr
滨: bbdb
宾: bbbb
摈: bbfb
兵: bkqb
冰: bkdu
柄: bkmb
丙: bkan
秉: bkpn
饼: bkuk
炳: bkhb
病: bkbb
并: bkbk
玻: bowy
菠: bocy
播: boft
拨: bofd
钵: bojb
波: body
博: bouc
勃: bwul
搏: bofc
铂: bojb
箔: bovb
伯: borb
帛: bobj
舶: bovb
脖: booz
膊: booc
渤: bodl
泊: podb
驳: bomx
捕: buff
卜: buld
哺: bukf
补: bupb
埠: butu
不: buad
布: buuj
步: buvp
簿: buvc
部: bule
怖: buxj
擦: cafx
猜: cdqo
裁: cduy
材: cdmc
才: cdap
财: cdkc
睬: cdom
踩: cdzm
采: cdpm
彩: cdpp
菜: cdcm
蔡: cdcx
餐: cjll
参: ufsp
蚕: cjti
残: cjdj
惭: cjxj
惨: cjxp
灿: cjhe
苍: chcv
舱: chvv
仓: chrv
沧: chdv
藏: zhci
操: ccfm
糙: ccmz
槽: ccmo
曹: ccao
草: cccu
厕: siid
策: cevn
侧: vdrd
册: cepa
测: ced
层: cgus
蹭: cgzo
插: iafj
叉: iayd
茬: iact
茶: iacm
查: iamd
碴: iaud
搽: iafm
察: iabx
岔: iabe
差: idyg
诧: iayq
拆: idfi
柴: idvm
豺: idvc
搀: ijfd
掺: xmfp
蝉: ijil
馋: ijud
谗: ijyd
缠: ijsl
铲: ijji
产: ijlp
阐: ijml
颤: vjwr
昌: ihoo
猖: ihqo
场: ihtp
尝: ihxs
常: ihxj
长: vhpn
偿: ihrs
肠: ihop
厂: ihap
敞: ihxw
畅: ihup
唱: ihko
倡: ihro
超: ictk
抄: icfu
钞: icju
朝: vcuo
嘲: vcko
潮: icdo
巢: icvg
吵: icku
炒: ichu
车: jual
扯: iefv
撤: iefw
掣: iepu
彻: ieid
澈: iedw
郴: ifme
臣: ifkl
辰: ifin
尘: ifxt
晨: ifon
忱: ifxv
沉: ifdj
陈: ife
趁: iftp
衬: ifpc
撑: igfu
称: ighx
城: igti
橙: igma
成: igwv
呈: igkw
乘: ugqn
程: ighw
惩: igix
澄: igda
诚: igyi
承: igvn
逞: igzw
骋: igmv
秤: ighp
吃: iikq
痴: iibk
持: iifc
匙: uiob
池: iidy
迟: iizi
弛: iigy
驰: iimy
耻: iiev
齿: iivk
侈: iirx
尺: iiun
赤: iitd
翅: iiux
斥: iipd
炽: iihb
充: iswe
冲: isdv
虫: isvd
崇: isex
宠: isbl
抽: izfy
酬: izyv
畴: iztc
踌: izzc
稠: izhk
愁: izhx
筹: izvc
仇: qqrj
绸: izsk
瞅: izoh
丑: izva
臭: xqzq
初: iupd
出: iuvk
橱: iumc
厨: iuic
躇: iuzo
锄: iujl
雏: iudf
滁: iudh
除: iueh
楚: iumr
础: iuui
储: iuro
矗: iuuq
搐: iuft
触: iudi
处: iuwb
揣: vvfe
川: irpl
穿: irby
椽: irmu
传: irrv
船: irvk
喘: irke
串: irll
疮: ilbv
窗: ilbw
幢: vljl
床: ilgm
闯: ilmm
创: ilrd
吹: ivkr
炊: ivhr
捶: ivfi
锤: ivji
垂: ivpa
春: iyfo
椿: iymo
醇: iyyz
唇: iyik
淳: vydz
纯: iyst
蠢: iyfi
戳: ioxg
绰: icsu
疵: cibb
茨: cicr
磁: ciuy
雌: civf
辞: ciqu
慈: cibx
瓷: cidw
词: ciyk
此: civb
刺: ciad
赐: cikw
次: cidr
聪: csex
葱: cscx
囱: cspw
匆: csbd
从: csrr
丛: csra
凑: czdt
粗: cum
醋: cuyo
簇: cuvu
促: curr
蹿: crzi
篡: crvs
窜: crb
摧: cvff
崔: cvef
催: cvr
脆: cvov
瘁: cvbu
粹: cvmu
淬: cvdu
翠: cvxu
村: cym
存: cyuz
寸: cyad
磋: coug
撮: zofy
搓: cofg
措: cofo
挫: coft
错: cojo
搭: dafk
达: dazd
答: davk
瘩: dabk
打: dafd
大: ddun
呆: ddkm
歹: ddax
傣: ddru
戴: ddub
带: ddfj
殆: dddk
代: ddry
贷: ddrr
袋: ddry
待: ddic
逮: ddzn
怠: ddsx
耽: djev
担: djfd
丹: djpa
单: djbl
郸: djbe
掸: ujfl
胆: djod
旦: djoa
氮: djqh
但: djrd
惮: daxl
淡: djdh
诞: djyz
弹: djgl
蛋: djvi
当: dhxe
挡: dhfe
党: dhxe
荡: dhcp
档: dhme
刀: dcvp
捣: dcfe
蹈: dczj
倒: dcrd
岛: dcpe
祷: dcpc
导: dcsc
到: dcad
稻: dchj
悼: dcxu
道: dczz
盗: dcdm
德: deix
得: dwic
的: dibu
蹬: dgza
灯: dghd
登: dgva
等: dgvc
瞪: dgoa
凳: dgvj
邓: dgye
堤: ditr
低: dird
滴: didk
迪: dizy
敌: diqw
笛: divy
狄: diqh
涤: didm
翟: vdxf
嫡: dink
抵: difd
底: digd
地: dity
蒂: dicj
第: divp
帝: diwj
弟: dibp
递: dizp
缔: disj
颠: dmur
掂: dmfk
滇: dmdb
碘: dmub
点: dmlh
典: dmlb
靛: dmfr
垫: dmft
电: dmlv
佃: tmrt
甸: dmbt
店: dmgk
惦: dmxk
奠: dmbd
淀: dmdr
殿: dmuy
碉: dnuk
叼: dnkd
雕: dnkf
凋: dndk
刁: dnva
掉: dnfu
吊: dnkj
钓: dnju
调: tnyk
跌: dpzu
爹: dpbx
碟: dpum
蝶: dpim
迭: dpzu
谍: dpym
叠: dpyq
丁: dkal
盯: dkod
叮: dkkd
钉: dkjd
顶: dkdr
鼎: dkov
锭: dkjr
定: dkbr
订: dkyd
丢: dqps
东: dsad
冬: dswd
董: dscv
懂: dsxv
动: dsel
栋: dsmd
侗: tsrk
恫: dsxk
冻: dsdd
洞: dsdk
兜: dzpe
抖: dzfu
斗: dzdu
陡: dzer
豆: dzaa
逗: dzza
痘: dzba
都: dzle
督: duuo
毒: dufm
犊: dund
独: duqi
读: duyd
堵: duto
睹: duoo
赌: duko
杜: dumt
镀: dujy
肚: duot
度: dugy
渡: dudy
妒: dunh
端: drle
短: drua
锻: drjy
段: drpy
断: drmj
缎: drsy
堆: dvtf
兑: dvbe
队: dver
对: dvyc
墩: dytw
吨: dykt
蹲: dyzc
敦: dyww
顿: dytr
囤: tykt
钝: dyjt
盾: dypo
遁: dyzo
掇: dofy
哆: dokx
多: doxx
夺: dodc
垛: dotm
躲: doum
朵: dojm
跺: dozm
舵: dovb
剁: dojd
惰: doxo
堕: hvet
蛾: eeiw
峨: eeew
鹅: eewn
俄: eerw
额: eeb
讹: eeyb
娥: eenw
恶: wuyx
厄: eeiv
扼: eefv
遏: eezv
鄂: eeke
饿: eeuw
恩: enkx
而: eral
儿: erpv
耳: eraa
尔: erdx
饵: erue
洱: erde
二: eraa
贰: eryr
发: favd
罚: fasd
筏: favg
伐: farg
乏: fapv
阀: famg
法: fads
珐: faws
藩: fjct
帆: fjjf
番: pjpt
翻: fjpx
樊: fjmd
矾: fjuf
钒: fjjf
繁: popx
凡: fjjd
烦: fjhr
反: fjpy
返: fjzy
范: fjcv
贩: fjky
犯: fjqv
饭: fjuy
泛: fjdf
坊: fhtf
芳: fhcf
方: fhdw
肪: fhof
房: fhhf
防: fhef
妨: fhnf
仿: fhrf
访: fhyf
纺: fhsf
放: fhfw
菲: fwcf
非: fwla
啡: fwkf
飞: fwvd
肥: fwob
匪: fwkf
诽: fwyf
吠: fwkq
肺: fwol
废: fwgd
沸: fwdf
费: fwfr
芬: ffcd
酚: ffyd
吩: ffkd
氛: ffqd
分: ffbd
纷: ffsd
坟: fftw
焚: ffmh
汾: ffdd
粉: ffmd
奋: ffdt
份: ffrd
忿: ffbx
愤: ffxr
粪: ffmb
丰: fgal
封: fgtc
枫: fgmx
蜂: fgif
峰: fgef
锋: fgjf
风: fgjx
疯: fgbx
烽: fghf
逢: fgzf
冯: fgdm
缝: fgsz
讽: fgyx
奉: fgfl
凤: fgjy
佛: furf
否: pibk
夫: fuan
敷: fufw
肤: fuof
孵: fulz
扶: fuff
拂: fuff
辐: fuit
幅: fujt
氟: fuqf
符: fuvc
伏: furq
俘: furz
服: fuoy
浮: fudz
涪: fudk
福: fupt
袱: fupq
弗: fuvl
甫: fuad
抚: fufw
辅: fuif
俯: furc
釜: fuba
斧: fubj
脯: fuof
腑: fuoc
府: fugc
腐: fugr
赴: futb
副: fuad
覆: fuxw
赋: fukv
复: fupw
傅: furc
付: furc
阜: fupu
父: fubx
腹: fuow
负: fudr
富: fubt
讣: fuyb
附: fuec
妇: fune
缚: fusc
咐: fukc
噶: gakv
嘎: gakg
该: gdyr
改: gdjw
概: gdmv
钙: gdjg
盖: gdym
溉: gddv
干: gjau
甘: gjna
杆: gjmg
柑: gjmg
竿: gjvg
肝: gjog
赶: gjtg
感: gjxx
秆: gjhg
敢: gjvw
赣: gjlr
冈: ghkx
刚: ghkd
钢: ghjx
缸: ghfg
肛: ghog
纲: ghsx
岗: ghex
港: ghds
杠: ghmg
篙: gcvk
皋: gcbu
高: gcwk
膏: gcwo
羔: gcyh
糕: gcmh
搞: gcfk
镐: gcjk
稿: gchk
告: gcnk
哥: gedk
歌: gedr
搁: gefk
戈: gead
鸽: gern
胳: geok
疙: gebq
割: gebd
革: genl
葛: gecv
格: gemk
蛤: haik
阁: gemk
隔: geel
铬: gejk
个: gerl
各: gewk
给: jisk
根: gfmg
跟: gfzg
耕: gglj
更: ggan
庚: gggn
羹: ggyd
埂: ggtg
耿: ggeh
梗: ggmg
工: gsaa
攻: gsgw
功: gsgl
恭: gscx
龚: gslb
供: gsrb
躬: gsug
公: gsbs
宫: gsbk
弓: gsvv
巩: gsgf
汞: gsgu
拱: gsfb
贡: gsgr
共: gscb
钩: gzjs
勾: gzbs
沟: gzds
苟: gzck
狗: gzqk
垢: gztk
构: gzms
购: gzks
够: gzbx
辜: guuu
菇: guck
咕: gukk
箍: guvj
估: gurk
沽: gudk
孤: guzg
姑: gunk
鼓: guuy
古: guuk
蛊: guim
骨: gulo
谷: gubk
股: guoy
故: guuw
顾: guir
固: gukk
雇: guhf
刮: gxqd
瓜: gxpn
剐: gxkd
寡: gxbd
挂: gxft
褂: gxpb
乖: gkqb
拐: gkfl
怪: gkxt
棺: grmk
关: grbt
官: grbk
冠: grbc
观: grye
管: grvk
馆: gruk
罐: grff
惯: grxr
灌: grdf
贯: grvr
光: glxw
广: glwp
逛: glzw
瑰: gvwg
规: gvfe
圭: gvtt
硅: gvut
归: gvle
龟: gvdv
闺: gvmt
轨: gvij
鬼: gvps
诡: gvyv
癸: gvvt
桂: gvmt
柜: jumj
跪: gvzv
贵: gvvr
刽: gvrd
辊: gyib
滚: gydy
棍: gymb
锅: gojn
郭: gowe
国: goky
果: goln
裹: gowy
过: gozc
哈: hakk
骸: hdgr
孩: hdzr
海: hddm
氦: hdqr
亥: hdwr
害: hdbk
骇: hdmr
酣: hjyg
憨: hjvx
邯: hjge
韩: hjuw
含: hjrk
涵: hjdk
寒: hjbd
函: hjlk
喊: hjkk
罕: hjbg
翰: hjux
撼: hjfx
捍: hjfg
旱: hjog
憾: hjxx
悍: hjxg
焊: hjhg
汗: hjdg
汉: hjdy
夯: hhdl
杭: hhmj
航: hhvj
壕: hctu
嚎: hcku
豪: hcwu
毫: hcwm
郝: hcte
好: hcnz
耗: hclm
号: hckv
浩: hcdk
呵: kekk
喝: yekv
荷: heck
菏: heck
核: hemr
禾: heqn
和: huhk
何: herk
合: herk
盒: herm
貉: movk
阂: hemr
河: hedk
涸: hedk
赫: hetd
褐: hepv
鹤: hedn
贺: helr
嘿: hwkh
黑: hwlh
痕: hfbg
很: hfig
狠: hfqg
恨: hfxg
哼: hgkl
亨: hgwl
横: hgmb
衡: hgii
恒: hgxg
轰: hsiy
哄: hskb
烘: hshb
虹: hsig
鸿: hsdn
洪: hsdb
宏: hsbs
弘: hsgs
红: hssg
喉: hzku
侯: hzru
猴: hzqu
吼: hzkv
厚: hziz
候: hzru
后: hzp
呼: hukh
乎: hupl
忽: huwx
瑚: huwo
壶: huuy
葫: huco
胡: huuo
蝴: huio
狐: huqg
糊: humo
湖: hudo
弧: hugg
虎: huhj
唬: hukj
护: hufh
互: huaa
沪: hudh
户: hudu
花: hxcb
哗: hxku
华: hxru
猾: hxqg
滑: hxdg
画: hxak
划: hxgd
化: hxrb
话: hxyk
槐: hkmg
徊: hkik
怀: hkxb
淮: hkdf
坏: hkt
欢: hryr
环: hrwb
桓: hrmg
还: hrzb
缓: hrsy
换: hrfd
患: hrix
唤: hrkd
痪: hrbd
豢: hrju
焕: hrhd
涣: hrdd
宦: hrbi
幻: hryv
荒: hlcv
慌: hlxv
黄: hlcb
磺: hlub
蝗: hliw
簧: hlvb
皇: hlbw
凰: hljw
惶: hlxw
煌: hlhw
晃: hlow
幌: hljw
恍: hlxw
谎: hlyv
灰: hvuh
挥: hvfi
辉: hvxi
徽: hviw
恢: hvxh
蛔: hvik
回: hvkk
毁: hvjy
悔: hvxm
慧: hvfx
卉: hvuc
惠: hvax
晦: hvom
贿: hvko
秽: hvhx
会: kkrs
烩: hvhs
汇: hvdk
讳: hvyw
诲: hvym
绘: hvss
荤: hyci
昏: hyuo
婚: hyno
魂: hyeg
浑: hydi
混: hydb
豁: hobk
活: hodk
伙: horh
火: hodr
获: hocq
或: hoga
惑: hogx
霍: hoyf
货: horr
祸: hopn
击: jiak
圾: jitj
基: jiqt
机: jimj
畸: jitk
稽: jiho
积: jihb
箕: jivb
肌: jioj
饥: jiuj
迹: jizd
激: jidw
讥: jiyj
鸡: jiyn
姬: jinl
绩: jisr
缉: jise
吉: jiuk
极: jimj
棘: jian
辑: jiie
籍: jivo
集: jirm
及: jipn
急: jidx
疾: jibu
汲: jidj
即: jige
嫉: jinu
级: jisj
挤: jifl
几: jipv
脊: jido
己: jivv
蓟: jicd
技: jify
冀: jilb
季: jihz
伎: qiry
祭: vdpx
剂: jiwd
悸: jixz
济: jidl
寄: jibk
寂: jiby
计: jiyu
记: jiyj
既: jigv
忌: jijx
际: jiex
妓: jiny
继: jisv
纪: jisj
嘉: jxuk
枷: jxmk
夹: jxan
佳: jxrt
家: jxbu
加: jxlk
荚: jxcj
颊: jxjr
贾: guxr
甲: jxll
钾: jxjj
假: jxry
稼: jxhu
价: jprl
架: jxlm
驾: jxlm
嫁: jxnu
歼: jmdq
监: jmlm
坚: jmlt
尖: jmxd
笺: jmvj
间: jmmo
煎: jmbh
兼: jmbn
肩: jmho
艰: jmyg
奸: jmng
缄: jmsk
茧: jmci
检: jmma
柬: jman
碱: jmuk
拣: jmfd
捡: jmfa
简: jmvo
俭: jmra
剪: jmbd
减: jmdk
荐: jmcz
槛: jmmm
鉴: jmlj
践: jmzj
贱: jmkj
见: jmke
键: jmjz
箭: jmvd
件: jmrn
健: jmrz
舰: jmve
剑: jmrd
饯: jmuj
渐: jmdj
溅: jmdj
涧: jmdo
建: jmzy
僵: jlra
姜: jlyn
将: jldc
浆: jldu
江: jldg
疆: jlga
蒋: jlcc
桨: jldm
奖: jldd
讲: jlyj
匠: jlkj
酱: jldy
降: xlel
蕉: jnch
椒: jnmy
礁: jnuh
焦: jnrh
胶: jnox
交: jnwx
郊: jnwe
浇: jndw
骄: jnml
娇: jnnl
嚼: jtkc
搅: jnfe
铰: jnjx
矫: jnul
侥: ycrw
脚: jnoe
狡: jnqx
角: jtdy
饺: jnux
缴: vosw
绞: jnsx
剿: jnvd
教: jnlw
酵: jnyz
轿: jnil
较: jnix
叫: jnkl
窖: jnbk
揭: qifv
接: jpfn
皆: jpbb
秸: jphk
街: jpii
阶: jpel
截: jpuf
劫: jptl
节: jpce
桔: jumk
杰: jpmh
捷: jpfr
睫: jpor
竭: jplv
洁: jpdk
结: jpsk
解: xpdn
姐: jpnq
戒: jpgc
藉: jico
芥: jpcl
界: jptl
借: jpro
介: jprl
疥: jpbl
诫: jpyc
届: jpuy
巾: jbll
筋: jbvl
斤: jbpl
金: jbra
今: jbrv
津: jbdy
襟: jbpx
紧: jblx
锦: jbjj
仅: jbry
谨: jbya
进: jbzj
靳: jbgj
晋: jbyo
禁: jbmx
近: jbzj
烬: jbhd
浸: jbdy
尽: jbid
劲: jkvl
荆: jkcd
兢: jkue
茎: jkcg
睛: jkoo
晶: jkoo
鲸: jkax
京: jkwx
惊: jkxx
精: jkmo
粳: jkmg
经: jks
井: jkal
警: jkck
景: jkox
颈: jkvr
静: jkfl
境: jkte
敬: jkcw
镜: jkje
径: jkig
痉: jkbg
靖: jklo
竟: jkle
竞: jkle
净: jkdl
炯: jshk
窘: jsb
揪: jqfh
究: jqbj
纠: jqsl
玖: jqwj
韭: jqfa
久: jqpn
灸: jqjh
九: jqpv
酒: jqdy
厩: jqiv
救: jqqw
旧: jqlo
臼: jqpa
舅: jqjl
咎: jqwk
就: jqwy
疚: jqbj
鞠: jugm
拘: jufk
狙: juqq
疽: jubq
居: juuk
驹: jumk
菊: jucm
局: juuk
咀: jukq
矩: juuj
举: juxl
沮: judq
聚: juen
拒: jufj
据: jufk
巨: juka
具: juqb
距: juzj
踞: juzk
锯: jujk
俱: jurb
句: gzbk
惧: juxb
炬: juhj
剧: juud
捐: jrfo
鹃: jrkn
娟: jrno
倦: jrrv
眷: jrjo
卷: jrjv
绢: jrso
撅: jtfr
攫: jtfy
抉: jtfg
掘: jtfi
倔: jtri
爵: jtpc
觉: jtxe
决: jtdg
诀: jtyg
绝: jtsb
均: jytd
菌: jych
钧: jyjd
军: jybi
君: jyyk
峻: jyew
俊: jyrw
竣: jylw
浚: xydw
郡: jyye
骏: jymw
喀: kakk
咖: kakk
卡: qxub
咯: kakk
开: kda
揩: kdfb
楷: kdmb
凯: kdej
慨: kdxv
刊: kjgd
堪: kjtv
勘: kjql
坎: kjtr
砍: kjur
看: kjuo
康: khgn
慷: khxn
糠: khmn
扛: khfg
抗: khfj
亢: khwj
炕: khhj
考: kclv
拷: kcfv
烤: kchv
靠: kcnf
坷: ketk
苛: keck
柯: kemk
棵: kemg
磕: keum
颗: kegr
科: kehu
壳: qnuj
咳: kekr
可: kedk
渴: kedv
克: keue
刻: kewd
客: kebk
课: keyg
肯: kfvo
啃: kfko
垦: kfgt
恳: kfgx
坑: kgtj
吭: kgkj
空: ksbg
恐: ksgx
孔: kszv
控: ksfg
抠: kzfx
口: kzla
扣: kzfk
寇: kzby
枯: kumk
哭: kukq
窟: kubi
苦: kuck
酷: kuy
库: kugi
裤: kupi
夸: kxd
垮: kxtk
挎: kxfk
跨: kxzk
胯: kxok
块: kktg
筷: kkvg
侩: kkrs
快: kkxg
宽: krb
款: krur
匡: klkw
筐: klvw
狂: klqw
框: klmw
矿: klug
眶: klow
旷: klog
况: klde
亏: kvev
盔: kvum
岿: kvee
窥: kvbe
葵: kvct
奎: kvdt
魁: kvgu
傀: kvrg
馈: kvur
愧: kvxg
溃: kvdr
坤: kytu
昆: kyob
捆: kyfm
困: kykm
括: kofk
扩: kofg
廓: koge
阔: komk
垃: latl
拉: lafl
喇: lakd
蜡: laio
腊: xioo
辣: lalu
啦: lakl
莱: ldcl
来: ldan
赖: ldur
蓝: ljcm
婪: ljmn
栏: ljms
拦: ljfs
篮: ljvm
阑: ljmj
兰: ljbs
澜: ljdj
谰: ljyj
揽: ljfe
览: ljle
懒: ljxr
缆: ljse
烂: ljhs
滥: ljdm
琅: lhwl
榔: lhme
狼: lhql
廊: lhge
郎: lhde
朗: lhdo
浪: lhdl
捞: lcfl
劳: lccl
牢: lcbn
老: lclb
佬: lcrb
姥: munb
酪: lcyk
烙: lohk
涝: lcdl
勒: lwgl
乐: lcpd
雷: lwyt
镭: lwjt
蕾: lwct
磊: lwuu
累: lwtx
儡: lwrt
垒: lwst
擂: lwft
肋: lwol
类: lwmd
泪: lwdo
棱: lkmw
楞: lgmf
冷: lgds
厘: liil
梨: lihm
犁: lihn
黎: lihu
篱: livd
狸: liql
离: liwd
漓: lidd
理: liwl
李: limz
里: lila
鲤: lial
礼: lipv
莉: licd
荔: licl
吏: lian
栗: lixm
丽: liad
厉: liiw
励: liil
砾: liul
历: liil
利: lihd
傈: lirm
例: lird
俐: lird
痢: libd
立: liwa
粒: liml
沥: lidl
隶: livn
力: livp
璃: liwd
哩: likl
俩: llrl
联: lmet
莲: lmcz
连: lmzi
镰: lmjn
廉: lmgn
怜: lmxs
涟: lmdz
帘: lmbj
敛: lmrw
脸: lmoa
链: lmjz
恋: lmwx
炼: lmhd
练: lmsd
粮: llml
凉: lldx
梁: lldm
粱: lldm
良: lldg
两: llad
辆: llil
量: llol
晾: llox
亮: llwj
谅: llyx
撩: lnfx
聊: lnee
僚: lnrx
疗: lnbl
燎: lnhx
寥: lnbp
辽: lnzl
潦: lndx
了: lnvl
撂: lnfk
镣: lnjx
廖: lngp
料: lnmu
列: lpdd
裂: lpdy
烈: lpdh
劣: lpul
猎: lpqo
琳: lbwm
林: lbmm
磷: lbul
霖: lbym
临: lbll
邻: lbre
鳞: lbal
淋: lbdm
凛: lbdx
赁: lbrr
吝: lbwk
拎: lbfs
玲: lkws
菱: lkcw
零: lkys
龄: lkvs
铃: lkjs
伶: lkrs
羚: lkys
凌: lkdw
灵: lkeh
陵: lkew
岭: lkes
领: lkrr
另: lkkl
令: lkrs
溜: lqdt
琉: lqwv
榴: lqmt
硫: lquv
馏: lqut
留: lqpt
刘: lqwd
瘤: lqbt
流: lqdv
柳: lqme
六: luwb
龙: lsud
聋: lsle
咙: lskl
笼: lsvl
窿: lsbu
隆: lseu
垄: lslt
拢: lsfl
陇: lsel
楼: lzmn
娄: lzmn
搂: lzfn
篓: lzvn
漏: lzdy
陋: lzev
芦: luch
卢: lulu
颅: lulr
庐: lugh
炉: luhh
掳: lufl
卤: lulx
虏: luhl
鲁: luao
麓: lumb
碌: luuu
露: luyk
路: luzk
赂: lukk
鹿: lugb
潞: ludk
禄: lupu
录: lueu
陆: luej
戮: luxg
驴: lvmh
吕: lvkk
铝: lvjk
侣: lvrk
旅: lvfn
履: lvuw
屡: lvun
缕: lvsn
虑: lvhx
氯: lvqu
律: lviy
率: ukwu
滤: lvdx
绿: lusu
峦: lrwe
挛: lrwu
孪: lrwz
滦: lrdm
卵: lrpd
乱: lrqv
掠: ltfx
略: lttk
抡: lyfb
轮: lyib
伦: lyrb
仑: lyrb
沦: lydb
纶: lysb
论: lyyb
萝: locx
螺: loix
罗: losx
逻: lozx
锣: lojx
箩: lovx
骡: lomx
裸: lopg
落: lock
洛: lodk
骆: lomk
络: losk
妈: manm
麻: magm
玛: mawm
码: maum
蚂: maim
马: mava
骂: makm
嘛: makm
吗: makm
埋: mjtl
买: mdvd
麦: mdfw
卖: mdud
迈: mdzw
脉: mooy
瞒: mjol
馒: mjuy
蛮: mjwi
满: mjdl
蔓: wjcy
曼: mjoy
慢: mjxy
漫: mjdy
谩: mjyy
芒: mhcw
茫: mhcw
盲: mhwo
氓: mhwm
忙: mhxw
莽: mhcc
猫: mcqt
茅: mccp
锚: mcjt
毛: mcpv
矛: mcsp
铆: mcje
卯: mcpe
茂: mccw
冒: moko
帽: mcjo
貌: mcve
贸: mcpr
么: mops
玫: mwww
枚: mwmw
梅: mwmm
酶: mwym
霉: mwym
煤: mwhm
没: mody
眉: mwvo
媒: mwnm
镁: mwjd
每: mwpm
美: mwyd
昧: mwow
寐: mwbw
妹: mwnw
媚: mwno
门: mfdv
闷: mfmx
们: mfrm
萌: mgco
蒙: mgcn
檬: mgmn
盟: mgom
锰: mgjm
猛: mgqm
梦: mgmx
孟: mgzm
眯: miom
醚: miyz
靡: migf
糜: mwgm
迷: mizm
谜: miyz
弥: migx
米: midm
秘: mihb
觅: mipe
泌: midb
蜜: mibi
密: mibe
幂: mibj
棉: mmmj
眠: mmom
绵: mmsj
冕: mmkv
免: mmdv
勉: mmdl
娩: mmnv
缅: mmsm
面: mmaa
苗: mnct
描: mnft
瞄: mnot
藐: mnce
秒: mnhu
渺: mndu
庙: mngy
妙: mnnu
蔑: mpcu
灭: mpah
民: mbvv
抿: mbfm
皿: mbla
敏: mbpw
悯: mbxw
闽: mbmi
明: mkoo
螟: mkib
鸣: mkkn
铭: mkjk
名: mkxk
命: mkre
谬: mqyp
摸: mofd
摹: mocu
蘑: mocu
模: mumd
膜: mood
磨: mogu
摩: mogu
魔: mogg
抹: mofm
末: moan
莫: mocd
墨: moht
默: mohq
沫: modm
漠: modd
寞: mobd
陌: moeb
谋: mzym
牟: mzsn
某: mzgm
拇: mufm
牡: munt
亩: muwt
姆: munm
母: muvd
墓: muct
暮: muco
幕: mucj
募: mucl
慕: mucx
木: muan
目: muka
睦: muot
牧: munw
穆: muhp
拿: naru
哪: nwke
呐: nekn
钠: najn
那: nave
娜: none
纳: nasn
氖: ndqn
乃: ndvp
奶: ndnn
耐: ndec
奈: nddx
南: njug
男: njtl
难: njyf
囊: nhay
挠: ncfw
脑: ncok
恼: ncxk
闹: ncmj
淖: vodu
呢: nikb
馁: nwun
内: nwld
嫩: nfnw
能: ngsb
妮: ninb
霓: niye
倪: nire
泥: nidb
尼: niub
拟: nifr
你: nirx
匿: nikk
腻: nior
逆: nizp
溺: nndd
蔫: nmch
拈: nmfk
年: nmpl
碾: nmun
撵: nmfi
捻: nmfx
念: nmrx
娘: nlnl
酿: nlyl
鸟: nnwd
尿: svuu
捏: npft
聂: npey
孽: npcz
啮: npkk
镊: npjy
镍: npjm
涅: npdt
您: nbrx
柠: nkmd
狞: nkqd
凝: nkdr
宁: nkbd
拧: nkfd
泞: nkdd
牛: nqpl
扭: nqfi
钮: nqji
纽: nqsi
脓: nson
浓: nsdn
农: nsdn
弄: nswc
奴: nuny
努: nunl
怒: nunx
女: nvva
暖: nroy
虐: ntha
疟: ycba
挪: nofe
懦: noxe
糯: nome
诺: noyk
哦: ookw
欧: oukr
鸥: oukn
殴: ouky
藕: oucy
呕: oukx
偶: oury
沤: oudx
啪: pakb
趴: pazb
爬: pavb
帕: pajb
怕: paxb
琶: pawb
拍: pdfb
排: pdff
牌: pdpu
徘: pdif
湃: pddf
派: pddn
攀: pjmu
潘: pjdt
盘: pjvm
磐: pjvu
盼: pjod
畔: pjtb
判: pjbd
叛: pjby
乓: phqd
庞: phgl
旁: phwf
耪: phlf
胖: pjob
抛: pcfl
咆: pcks
刨: pcbd
炮: pchs
袍: pcps
跑: pczs
泡: pcds
呸: pwkp
胚: pwop
培: pwtk
裴: pwfy
赔: pwkk
陪: pwek
配: pwyj
佩: pwrj
沛: pwdl
喷: pfkr
盆: pfbm
砰: pgup
抨: pgfp
烹: pgwh
澎: pgdp
彭: pgup
蓬: pgcz
棚: pgmo
硼: pguo
篷: pgvz
膨: pgop
朋: pgoo
鹏: pgon
捧: pgfl
碰: pguy
坯: pita
砒: piub
霹: piyu
批: pifb
披: pify
劈: piud
琵: piwb
毗: pitb
啤: piku
脾: piou
疲: piby
皮: pivy
匹: pike
痞: pibk
僻: piru
屁: piub
譬: piuk
篇: pmvc
偏: pmrc
片: pmpv
骗: pmmc
飘: pnxx
漂: pndx
瓢: pnxg
票: pnxx
撇: ppfw
瞥: ppdo
拼: pbfk
频: pbvr
贫: pbbr
品: pbkk
聘: pbev
乒: pkqp
坪: pktp
苹: pkcp
萍: pkcp
平: pkau
凭: pkrj
瓶: pkbw
评: pkyp
屏: pkuk
坡: poty
泼: podd
颇: povr
婆: podn
破: pouy
魄: pobg
迫: pozb
粕: pomb
剖: pzld
扑: pufb
铺: pujf
仆: purb
莆: pucf
葡: pucf
菩: puck
蒲: pucf
埔: putf
朴: pumb
圃: pukf
普: pubo
浦: pudf
谱: puyo
曝: puou
瀑: bcdu
期: qiqo
欺: qiqr
栖: ximx
戚: qiad
妻: qian
七: qiav
凄: qidn
漆: qidu
柒: qidm
沏: qidd
其: qiqb
棋: qimb
奇: jidk
歧: qivy
畦: qitt
崎: qiek
脐: qiol
齐: qiwl
旗: qifb
祈: qipj
祁: qipe
骑: qimk
起: qitj
岂: qiej
乞: qipv
企: qirv
启: qihk
契: xpfd
砌: qiud
器: qikk
气: qipv
迄: qizq
弃: qiwc
汽: qidq
泣: qidl
讫: qiyq
掐: qxfj
恰: qxxk
洽: qxdk
牵: qmdn
扦: qmfq
钎: qmjq
铅: qmjk
千: qmpu
迁: qmzq
签: qmva
仟: qmrq
谦: qmyn
乾: qmuq
黔: qmhv
钱: qmjj
钳: qmjg
前: qmbd
潜: qmdo
遣: qmzk
浅: qmdj
谴: qmyz
堑: qmit
嵌: qmer
欠: qmdr
歉: qmbr
枪: qlmv
呛: qlkv
腔: qlog
羌: qlyv
墙: qltk
蔷: qlck
强: qlgi
抢: qlfv
橇: qnmm
锹: qnjh
敲: qnwy
悄: qnxo
桥: qnml
瞧: qnoh
乔: qnyl
侨: qnrl
巧: qngv
鞘: ucgo
撬: qnfm
翘: qnax
峭: qneo
俏: qnro
窍: qnbv
切: qpqd
茄: qpck
且: qpla
怯: qpxs
窃: qpbd
钦: qbjr
侵: qbry
亲: qblm
秦: qbfh
琴: qbwv
勤: qbnl
芹: qbcj
擒: qbfd
禽: qbrd
寝: qbby
沁: qbdx
青: qkfo
轻: qkig
氢: qkqg
倾: qkrr
卿: qkpe
清: qkdo
擎: qkcu
晴: qkoo
氰: qkqo
情: qkxo
顷: qkbr
请: qkyo
庆: qkgd
琼: qswx
穷: qsbl
秋: qqhh
丘: qqpa
邱: qqqe
球: qqwq
求: qqad
囚: qqkr
酋: qqby
泅: qqdr
趋: qute
区: qukx
蛆: quiq
曲: qula
躯: quux
屈: quui
驱: qumx
渠: qudm
取: quey
娶: quen
龋: quvy
趣: quty
去: quts
圈: qrkv
颧: qrcr
权: qrmy
醛: qryw
泉: qrbu
全: qrrw
痊: qrbw
拳: qrju
犬: qrdd
券: xrjd
劝: qryl
缺: qtfg
炔: qthg
瘸: qtbr
却: qtte
鹊: qtcn
榷: qtmf
确: qtuy
雀: qtuf
裙: qypk
群: qyyy
然: rjph
燃: rjhh
冉: rjla
染: rjdm
瓤: rhwg
壤: rhty
攘: rhfy
嚷: rhky
让: rhyu
饶: rcuw
扰: rcfy
绕: rcsw
惹: recx
热: refh
壬: rfpu
仁: rfre
人: rfpn
忍: rfrx
韧: rfwr
任: rfrr
认: rfyr
刃: rfdd
妊: rfnr
纫: rfsr
扔: rgfn
仍: rgrn
日: rika
戎: rsgu
茸: rsce
蓉: rsck
荣: rscm
融: rsai
熔: rshk
溶: rsdk
容: rsbk
绒: rssu
冗: rsbj
揉: rzfm
柔: rzsm
肉: rznr
茹: ruck
蠕: ruie
儒: rure
孺: ruze
如: runk
辱: ruic
乳: rupv
汝: rudn
入: rupn
褥: rupc
软: rrir
阮: rree
蕊: rvcx
瑞: rvwe
锐: rvje
闰: rymw
润: rydw
若: rock
弱: rogd
撒: safw
洒: sadx
萨: saci
腮: sdox
鳃: sdax
塞: sdbt
赛: sdbr
三: sjae
叁: sjss
伞: sjru
散: sjcw
桑: shym
嗓: shkm
丧: shun
搔: scfi
骚: scmi
扫: scfe
嫂: scny
瑟: sewb
色: uddb
涩: sedv
森: sfmm
僧: sgro
莎: uacu
砂: uauu
杀: uaxm
刹: uaxd
沙: uadu
纱: uasu
傻: uarw
啥: uakk
煞: uadh
筛: udvj
晒: udox
珊: ujwc
苫: ujck
杉: uamp
山: ujlk
删: ujcd
煽: ujhx
衫: ujpp
闪: ujmr
陕: ujej
擅: ujfd
赡: ujkk
膳: ujok
善: ujyk
汕: ujde
扇: ujhx
缮: ujsk
墒: uhtk
伤: uhrl
商: uhwk
赏: uhxr
晌: uhok
上: uhla
尚: uhxk
裳: uhxy
梢: ucmo
捎: ucfo
稍: ucho
烧: uchw
芍: uccu
勺: ucbd
韶: uclk
少: ucxp
哨: ucko
邵: ucde
绍: ucsk
奢: uedo
赊: uekx
蛇: yiib
舌: ueqk
舍: uerk
赦: uetw
摄: uefy
射: yiuc
慑: uexy
涉: uedp
社: uept
设: ueyy
砷: ufuu
申: ufll
呻: ufku
伸: ufru
身: ufpp
深: ufdm
娠: ufnn
绅: ufsu
神: ufpu
沈: ufdv
审: ufbu
婶: ufnu
甚: ufqv
肾: uflo
慎: ufxb
渗: ufdp
声: ugup
生: ugpf
甥: ugul
牲: ugnu
升: ugpc
绳: ugsd
省: xkuo
盛: ugim
剩: ugqd
胜: ugou
圣: ugyt
师: uilj
失: uipf
狮: uiqj
施: uify
湿: uidy
诗: uiyc
尸: uivp
虱: uivi
十: uial
石: uiak
拾: uifk
时: uioc
什: ufru
食: yirl
蚀: uiui
实: uibd
识: viyb
史: uiln
矢: uipt
使: uirl
屎: uium
驶: uimu
始: uink
式: uiyg
示: uiex
士: uiua
世: uiav
柿: uimj
事: uial
拭: uifg
誓: uifk
逝: uizj
势: uifl
是: uior
嗜: uiko
噬: uikr
适: uizk
仕: uiru
侍: uirc
释: uipl
饰: uiuj
氏: uipv
市: uiwj
恃: uixc
室: uibt
视: uipe
试: uiyg
收: uzvw
手: uzpl
首: uzbz
守: uzbc
寿: uzfc
授: uzfy
售: uzrk
受: uzpy
瘦: uzby
兽: uzbk
蔬: uucv
枢: uumx
梳: uumv
殊: uudv
抒: uufl
输: uuid
叔: uuuy
舒: uurl
淑: uudy
疏: uuvv
书: uuvd
赎: uukd
孰: uuww
熟: uzwh
薯: uuco
暑: uuoo
曙: uuoo
署: uuso
蜀: uusi
黍: uuhu
鼠: uujv
属: uuuy
术: vumd
述: uuzu
树: uumc
束: uuan
戍: uuad
竖: uull
墅: uult
庶: uugh
数: uomw
漱: uudr
恕: uunx
刷: uxud
耍: uxen
摔: ukfu
衰: ukwy
甩: ukkv
帅: uklj
栓: urmw
拴: urfw
霜: ulyo
双: ulyy
爽: ulan
谁: uvyf
水: uvln
睡: uvoi
税: uvhe
吮: uyke
瞬: uyol
顺: uyir
舜: uypl
说: ytye
硕: uour
朔: uobo
烁: uohl
斯: siqj
撕: sifj
嘶: sikj
思: sdtx
私: sihs
司: sivk
丝: siva
死: sidb
肆: siay
寺: sitc
嗣: sikk
四: sike
伺: sirk
似: uirr
饲: siuk
巳: sivv
松: ssms
耸: ssre
怂: ssrx
颂: ssbr
送: sszt
宋: ssbm
讼: ssys
诵: ssyy
搜: szfy
艘: szvy
擞: szfw
嗽: szkr
苏: sucb
酥: suyh
俗: surk
素: sufx
速: suzu
粟: suxm
僳: surm
塑: subt
溯: sudo
宿: xqbb
诉: suyi
肃: suvd
酸: sryw
蒜: srcx
算: srvc
虽: svki
隋: sveo
随: svez
绥: svsn
髓: svgz
碎: svuu
岁: svex
穗: svhx
遂: svzu
隧: svez
祟: svix
孙: syzx
损: syfr
笋: syvy
蓑: socy
梭: somw
唆: sokw
缩: sosb
琐: sowr
索: soux
锁: sojr
所: sopj
塌: tatx
他: tary
它: tabb
她: tany
塔: tatk
獭: taqr
挞: tafz
蹋: tazx
踏: tazo
胎: tdok
苔: tdck
抬: tdfk
台: tdsk
泰: tdfu
酞: tdyt
太: tddd
态: tdtx
汰: tddt
坍: tjtd
摊: tjff
贪: tjrr
瘫: tjbf
滩: tjdf
坛: tjts
檀: tjmd
痰: tjbh
潭: tjdu
谭: tjyu
谈: tjyh
坦: tjtd
毯: tjmh
袒: tjpd
碳: tjuh
探: tjfm
叹: tjky
炭: tjeh
汤: uhdp
塘: thtk
搪: thfk
堂: thxt
棠: thxm
膛: thot
唐: thgk
糖: thmk
倘: thrk
躺: thuk
淌: thdk
趟: thtk
烫: thdh
掏: tcff
涛: tcdc
滔: tcdj
绦: tcsm
萄: tccf
桃: tcmd
逃: tczd
淘: tcdf
陶: tcef
讨: tcyc
套: tcds
特: tenc
藤: tgcu
腾: tgom
疼: tgbd
誊: tgjk
梯: timp
剔: tiod
踢: tizw
锑: tijp
提: tifr
题: tior
蹄: tizj
啼: tikj
体: tirb
替: tifo
嚏: tikr
惕: tixw
涕: tidp
剃: tibd
屉: tiuu
天: tmad
添: tmdx
填: tmtb
田: tmku
甜: tmqg
恬: tmxk
舔: tmqx
腆: tmob
挑: tnfd
条: tnwm
迢: tnzk
眺: tnod
跳: tnzd
贴: tpkk
铁: tpju
帖: tpjk
厅: tkid
听: tkkj
烃: tkhg
汀: tkdd
廷: tkzr
停: tkrd
亭: tkwd
庭: tkgz
挺: tkfz
艇: tkvz
通: tszy
桐: tsmk
酮: tsyk
瞳: tsol
同: tskk
铜: tsjk
彤: tsdp
童: tsll
桶: tsmy
捅: tsfy
筒: tsvk
统: tsse
痛: tsby
偷: tzrd
投: tzfy
头: tzdd
透: tzzn
凸: tula
秃: tuhj
突: tubq
图: tukd
徒: tuir
途: tuzh
涂: tudh
屠: tuuo
土: tuua
吐: tukt
兔: tudd
湍: trde
团: trkc
推: tvff
颓: tvhr
腿: tvoz
蜕: tvie
褪: typz
退: tvzg
吞: tytk
屯: vyav
臀: tyuo
拖: tofy
托: tofq
脱: tooe
鸵: tonb
陀: toeb
驮: domd
驼: tomb
椭: tomo
妥: topn
拓: tofu
唾: toki
挖: wafv
哇: wakt
蛙: wait
洼: wadt
娃: want
瓦: waad
袜: wapm
歪: wdpv
外: wdxb
豌: wjav
弯: wjwg
湾: wjdg
玩: wjwe
顽: wjer
丸: wjpd
烷: wjhe
完: wjbe
碗: wjuv
挽: wjfv
晚: wjov
皖: wjbe
惋: wjxv
宛: yrbv
婉: wjnv
万: moap
腕: wjov
汪: whdw
王: what
亡: whwv
枉: whmw
网: whkx
往: whiv
旺: whow
望: whww
忘: whwx
妄: whwn
威: wwxn
巍: wweg
微: wwiw
危: wwdv
韦: wwal
违: wwzw
桅: wwmv
围: wwkw
唯: wwkf
惟: wwxf
为: wwdd
潍: wwdf
维: wwsf
苇: wwcw
萎: wwcn
委: wwhn
伟: wwrw
伪: wwrw
尾: yium
纬: wwsw
未: wwan
蔚: yucc
味: wwkw
畏: wwtn
胃: wwto
喂: wwkn
魏: wwhg
位: wwrl
渭: wwdo
谓: wwyo
尉: yuuc
慰: wwux
卫: wwva
瘟: wfbm
温: wfdm
蚊: wfiw
文: wfwx
闻: wfme
纹: wfsw
吻: wfkw
稳: wfhx
紊: wfwx
问: wfmk
嗡: wgkx
翁: wgbx
瓮: wgbw
挝: vxfz
蜗: woin
涡: wodn
窝: wobn
我: wopd
斡: wouu
卧: woib
握: woft
沃: wody
巫: wugr
呜: wukw
钨: wujw
乌: wupa
污: wudk
诬: wuyr
屋: wuut
无: wuav
芜: wucw
梧: wumk
吾: wuwk
吴: wukt
毋: wuva
武: wuav
五: wuaa
捂: wufk
午: wupg
舞: wupl
伍: wurw
侮: wurm
坞: wutw
戊: wugp
雾: wuyl
晤: wuok
物: wunw
勿: wubp
务: wuwl
悟: wuxk
误: wuyt
昔: xico
熙: xikh
析: ximj
西: xiaa
硒: xiux
晰: xioj
嘻: xikk
吸: xikj
锡: xijw
牺: xinx
稀: xihj
息: xizx
希: xixj
悉: xipx
膝: xiou
夕: xipd
惜: xixo
熄: xihx
烯: xihj
溪: xidd
汐: xidx
犀: xiun
檄: ximw
袭: xily
席: xigj
习: xivd
媳: xinx
喜: xiuk
铣: xmje
洗: xide
系: xipx
隙: xiex
戏: xiyg
细: xist
瞎: xxok
虾: xxix
匣: xxkj
霞: xxyy
辖: xxik
暇: xxoy
峡: xxej
侠: xxrj
狭: xxqj
下: xxab
厦: xxiw
夏: xxaw
吓: xxkx
掀: xmfr
锨: xmjr
先: xmne
仙: xmre
鲜: xmay
纤: xmsq
咸: xmxk
贤: xmlr
衔: xmii
舷: xmvy
闲: xmmm
涎: xmdz
弦: xmgy
嫌: xmnn
显: xmoy
险: xmea
现: xmwe
献: xmuq
县: xmqs
腺: xmou
馅: xmuj
羡: xmyr
宪: xmbe
陷: xmej
限: xmeg
线: xmsj
相: xlmo
厢: xlio
镶: xljy
香: xlho
箱: xlvo
襄: xlwy
湘: xldo
乡: xlvp
翔: xlyx
祥: xlpy
详: xlyy
想: xlmx
响: xlkk
享: xlwz
项: xlgr
巷: xlcs
橡: xlmn
像: xlrn
向: xlpk
象: xldn
萧: xncs
硝: xnuo
霄: xnyo
削: xtxd
哮: xnkz
嚣: xnkk
销: xnjo
消: xndo
宵: xnbo
淆: xndo
晓: xnow
小: xnld
孝: xnlz
校: xnmx
肖: xnxo
啸: xnks
笑: xnvy
效: xnww
楔: xpmd
些: xpve
歇: xpor
蝎: xpiv
鞋: xpgt
协: xpub
挟: xpfj
携: xpfn
邪: yeye
斜: xpru
胁: xpob
谐: xpyb
写: xpby
械: xpmc
卸: xpwe
蟹: xpdi
懈: xpxn
泄: xpdu
泻: xpdy
谢: xpyc
屑: xpuo
薪: xbcj
芯: xbcx
锌: xbju
欣: xbjr
辛: xblu
新: xblj
忻: xbxj
心: xbdd
信: xbrk
衅: xbxb
星: xkou
腥: xkou
猩: xkqu
惺: xkxu
兴: xkxb
刑: xkkd
型: xkkt
形: xkkp
邢: xkke
行: hhii
醒: xkyu
幸: xktg
杏: xkmk
性: xkxu
姓: xknu
兄: xske
凶: xsxk
胸: xsok
匈: xsbk
汹: xsdk
雄: xsuf
熊: xssh
休: xqrm
修: xqrp
羞: xqyi
朽: xqmv
嗅: xqkq
锈: xqjn
秀: xqhn
袖: xqpy
绣: xqsn
墟: xuty
戌: xuad
需: xuye
虚: xuhy
嘘: xuky
须: xupr
徐: xuih
许: xuyw
蓄: xuct
酗: xuyk
叙: xury
旭: xujo
序: xugl
畜: xuwt
恤: xuxx
絮: xunx
婿: xuno
绪: xuso
续: xusd
轩: xrig
喧: xrkg
宣: xrbg
悬: xrqx
旋: xrfr
玄: xrwy
选: xrze
癣: xrby
眩: xroy
绚: xrso
靴: xtgb
薛: xtcu
学: xtxz
穴: xtbb
雪: xtye
血: xtpm
勋: xykl
熏: xyph
循: xyio
旬: xybo
询: xyyo
寻: xyec
驯: xymi
巡: xyzv
殉: xydo
汛: xydu
训: xyyi
讯: xyyu
逊: xyzx
迅: xyzu
压: yaid
押: yafj
鸦: yayn
鸭: yajn
呀: yaky
丫: yabl
芽: yacy
牙: yaap
蚜: yaiy
崖: yaet
衙: yaii
涯: yadt
雅: yayf
哑: yaky
亚: yaay
讶: yayy
焉: yjvh
咽: yjkd
阉: yjmd
烟: yjhd
淹: yjdd
盐: yjtm
严: yjyp
研: yjuk
蜒: yjiz
岩: yjeu
延: yjzv
言: yjwk
颜: yjir
阎: yjmj
炎: yjhh
沿: yjdk
奄: yjdd
掩: yjfd
眼: yjog
衍: yjii
演: yjdb
艳: yjfb
堰: yjtn
燕: yjnh
厌: yjiq
砚: yjue
雁: yjif
唁: yjkk
彦: yjip
焰: yjhj
宴: yjbn
谚: yjyp
验: yjma
殃: yhdy
央: yhlg
鸯: yhyn
秧: yhhy
杨: yhmp
扬: yhfp
佯: yhry
疡: yhbp
羊: yhbl
洋: yhdy
阳: yheo
氧: yhqy
仰: yhre
痒: yhby
养: yhyl
样: yhmy
漾: yhdy
邀: yczw
腰: ycon
妖: ycny
瑶: ycwf
摇: ycff
尧: ycaw
遥: yczf
窑: ycbf
谣: ycyf
姚: ycnd
咬: yckx
舀: ycpj
药: yccu
要: ycxn
耀: ycxf
椰: yeme
噎: yeka
耶: yeee
爷: yebe
野: yell
冶: yedk
也: yevv
页: year
掖: yefn
业: yela
叶: yeku
曳: yelp
腋: yeon
夜: yewn
液: yedn
一: yiaa
壹: yiua
医: yiku
揖: yife
铱: yijy
依: yiry
伊: yiry
衣: yiwy
颐: yikr
夷: yian
遗: yizr
移: yihx
仪: yiry
胰: yioy
疑: yibr
沂: yidj
宜: yibq
姨: yiny
彝: yivc
椅: yimk
蚁: yiiy
倚: yirk
已: yivv
乙: yivv
矣: yisu
以: yivr
艺: yicv
抑: yife
易: yiow
邑: yikb
屹: yieq
亿: yirv
役: yiiy
臆: yiox
逸: yizd
肄: yiby
疫: yiby
亦: yiwd
裔: yiwk
意: yilx
毅: yily
忆: yixv
义: yidx
益: yibm
溢: yidm
诣: yiyo
议: yiyy
谊: yiyq
译: yiyl
异: yisc
翼: yixb
翌: yixl
绎: yisl
茵: ybcd
荫: ybco
因: ybkd
殷: yjpy
音: yblo
阴: ybeo
姻: ybnd
吟: ybkv
银: ybjg
淫: ybdr
寅: ybbb
饮: ybur
尹: ybvp
引: ybgl
隐: ybex
印: ybpe
英: ykcy
樱: ykmn
婴: ykkn
鹰: ykgn
应: ykga
缨: yksn
莹: ykcy
萤: ykci
营: ykck
荧: ykch
蝇: ykid
迎: ykze
赢: ykwf
盈: yknm
影: ykop
颖: ykbr
硬: ykug
映: ykoy
哟: yoku
拥: ysfy
佣: ysry
臃: ysof
痈: ysby
庸: ysgl
雍: yswf
踊: yszy
蛹: ysiy
咏: ysky
泳: ysdy
涌: ysdy
永: ysdn
恿: yssx
勇: yssl
用: yskl
幽: yzey
优: yzry
悠: yzrx
忧: yzxy
尤: yzyd
由: yzla
邮: yzye
铀: yzjy
犹: yzqy
油: yzdy
游: yzdz
酉: yzxa
有: yzuo
友: yzuy
右: yzuk
佑: yzrk
釉: yzpy
诱: yzyn
又: yzvn
幼: yzyl
迂: yuzy
淤: yudd
于: yual
盂: yuym
榆: yumd
虞: yuht
愚: yuyx
舆: yupb
余: yurh
俞: yurd
逾: yuzd
鱼: yuda
愉: yuxd
渝: yudd
渔: yuda
隅: yuey
予: yusl
娱: yunt
雨: yuad
与: yuaa
屿: yuey
禹: yupd
宇: yuby
语: yuyk
羽: yuxx
玉: yuwd
域: yuta
芋: yucy
郁: yuue
吁: yuky
遇: yuzy
喻: yukd
峪: yuek
御: yuie
愈: yurx
欲: yubr
狱: yuqq
育: yuwo
誉: yuxk
浴: yudk
寓: yuby
裕: yupk
预: yusr
豫: yusn
驭: yumy
鸳: yrxn
渊: yrdl
冤: yrbd
元: yree
垣: yrtg
袁: yrty
原: yrix
援: yrfy
辕: yriy
园: yrke
员: yrkr
圆: yrkr
猿: yrqy
源: yrdx
缘: yrsu
远: yrze
苑: yrcv
愿: yrix
怨: yrxx
院: yree
曰: ytka
约: ytsu
越: yttv
跃: ytzy
钥: ytjo
岳: ytqe
粤: ytpv
月: ytka
悦: ytxe
阅: ytme
耘: yyls
云: yyes
郧: yyke
匀: yybd
陨: yyer
允: yyse
运: yyzs
蕴: yycm
酝: yyys
晕: yyoi
韵: yyld
孕: yynz
匝: zakj
砸: zauj
杂: zajm
栽: zdum
哉: zduk
灾: zdbh
宰: zdbu
载: zdui
再: zdar
在: zdut
咱: zjkz
攒: zjfr
暂: zjio
赞: zjnr
赃: zhkt
脏: zhot
葬: zhcc
遭: zczo
糟: zcmo
凿: zcyk
藻: zccm
枣: zcad
早: zcou
澡: zcdm
蚤: zcii
躁: zczm
噪: zckm
造: zczk
皂: zcbq
灶: zcht
燥: zchm
责: zefr
择: zefl
则: zekd
泽: zedl
贼: zwku
怎: zfvx
增: zgto
憎: zgxo
曾: zgbo
赠: zgko
扎: zafv
喳: vakd
渣: vadd
札: vamv
轧: vaiv
铡: vajd
闸: vamj
眨: vaof
栅: vamc
榨: vamv
咋: zekv
乍: vapa
炸: vahv
诈: vayv
摘: vdfk
斋: vdwe
宅: vdbq
窄: vdbv
债: vdrr
寨: vdbm
瞻: vjok
毡: vjmk
詹: vjdk
粘: vjmk
沾: vjdk
盏: vjjm
斩: vjij
辗: vjin
崭: vjej
展: vjun
蘸: vjch
栈: vjmj
占: vjlk
战: vjlg
站: vjlk
湛: vjdv
绽: vjsr
樟: vhmu
章: vhlu
彰: vhlp
漳: vhdu
张: vhgi
掌: vhxu
涨: vhdi
杖: vhmv
丈: vhan
帐: vhji
账: vhki
仗: vhrv
胀: vhoi
瘴: vhbu
障: vheu
招: vcfk
昭: vcok
找: vcfg
沼: vcdk
赵: vctx
照: vcoh
罩: vcsu
兆: vced
肇: vchy
召: vcdk
遮: vezh
折: vefj
哲: vefk
蛰: vefi
辙: veiw
者: velo
锗: vejo
蔗: vech
这: vwzw
浙: vedj
珍: vfwp
斟: vfqu
真: vfub
甄: vfxw
砧: vfuk
臻: vfah
贞: vflr
针: vfju
侦: vfrr
枕: vfmv
疹: vfbp
诊: vfyp
震: vfyn
振: vffn
镇: vfjb
阵: vfei
蒸: vgch
挣: vgfl
睁: vgol
征: vgiv
狰: vgql
争: vgdl
怔: vgxv
整: vguv
拯: vgfa
正: vgav
政: vgvw
帧: vfjr
症: vgbv
郑: vgbe
证: vgyv
芝: vicv
枝: vimy
支: viuy
吱: ziky
蜘: viik
知: viuk
肢: vioy
脂: vioo
汁: vidu
之: vidn
织: visb
职: vieb
直: viuq
植: vimq
殖: vidq
执: vifw
值: virq
侄: virt
址: vitv
指: vifo
止: vila
趾: vizv
只: vikb
旨: vibo
纸: visu
志: viux
挚: vifu
掷: vife
至: viat
致: viaw
置: visq
帜: vijb
峙: viec
制: vipd
智: viuo
秩: vihu
稚: vihf
质: vipr
炙: viph
痔: vibc
滞: vidj
治: vidk
窒: vibt
中: vsll
盅: vsvm
忠: vsvx
钟: vsjv
衷: vswy
终: vssd
种: ishv
肿: vsov
重: vspa
仲: vsrv
众: vsrr
舟: vzpd
周: vzkk
州: vzdl
洲: vzdv
诌: vzye
粥: vzgg
轴: vziy
肘: vzoc
帚: vzej
咒: vzkj
皱: vzdy
宙: vzby
昼: vzid
骤: vzmn
珠: vuwv
株: vumv
蛛: vuiv
朱: vunn
猪: vuqo
诸: vuyo
诛: vuyv
逐: vuzu
竹: vupl
烛: vuhi
煮: vulh
拄: vufv
瞩: vuoy
嘱: vuky
主: vudw
著: vuco
柱: vumv
助: vuql
蛀: vuiv
贮: vuka
铸: vujc
筑: vuvf
住: vurv
注: vudv
祝: vupe
驻: vumv
抓: vxfv
爪: vxpn
拽: vkfy
专: vrad
砖: vruv
转: vriv
撰: vrfb
赚: zrk
篆: vrvu
桩: vlmt
庄: vlgt
装: vldy
妆: vldn
撞: vlfl
壮: vldu
状: vldq
椎: vvmf
锥: vvjf
追: vvzk
赘: vvfr
坠: vvet
缀: vvsy
谆: vyyz
准: vydf
捉: vofr
拙: vofi
卓: volu
桌: volm
琢: zown
茁: voci
酌: voyu
啄: vokn
着: voyo
灼: vohu
浊: vodi
兹: ziby
咨: zidk
资: zidr
姿: zidn
滋: zidy
淄: zidt
孜: zizw
紫: zivx
仔: zirz
籽: zimz
滓: zidu
子: ziva
自: zipo
渍: zidr
字: zibz
鬃: zsax
棕: zsmx
踪: zszx
宗: zsbx
综: zssx
总: zsbx
纵: zssr
邹: zzde
走: zztr
奏: zzft
揍: zzft
租: zuhq
足: zukr
卒: zuwu
族: zufu
祖: zupq
诅: zuyq
阻: zueq
组: zusq
钻: zrjk
纂: zrvx
嘴: zvky
醉: zvyu
最: zvoy
罪: zvsf
尊: zybc
遵: zyzc
昨: zoov
左: zoug
佐: zorg
柞: vamv
做: zorw
作: zorv
坐: zort
座: zogt
