亍: iuel
兀: wuae
丐: gdav
廿: nmaa
卅: saal
丕: piba
亘: gfad
丞: igla
鬲: geal
孬: ncbz
噩: eeaa
禺: yuld
匕: bipv
夭: ycpd
爻: ycxx
卮: vipv
氐: diud
囟: xbpx
胤: ybpv
馗: kvjz
毓: yupv
睾: gcpg
鼗: tcey
亟: qila
鼐: ndnv
乜: npvv
乩: jilv
亓: qiel
芈: mill
孛: bwuz
啬: seuk
嘏: guuy
仄: zeir
厍: ueii
厝: coio
厣: yjij
厥: jtir
厮: siij
靥: yeim
赝: yjir
叵: pokk
匦: gvkj
匮: gvkr
匾: bmkc
赜: zekr
卦: gxtb
卣: yzla
刈: yixd
刎: wfwd
刭: jkvd
刳: kudd
刿: gved
剀: kded
剌: laud
剞: jidd
剡: yjhd
剜: wjbd
蒯: kkcd
剽: pnxd
劂: jtid
劁: qnrd
劐: hocd
劓: yizd
罔: whkw
仃: dkrd
仉: vhrj
仂: lerl
仨: sars
仡: yirq
仫: murm
仞: rfrr
伛: yurx
仳: pirb
伢: yary
佤: warw
仵: wurw
伥: ihri
伧: ifrv
伉: khrj
伫: vura
佞: nkrn
攸: yzrw
佚: dpru
佝: gzrk
佟: tsrd
佗: torb
伲: nirb
伽: qprk
佶: jirk
佴: ndre
侑: yzro
侉: kxrk
侃: kjrv
侏: vurv
佾: yiro
佻: tnrd
侪: idrl
佼: jnrx
侬: nsrn
侔: mzrn
俦: izrc
俨: yjry
俪: lirl
俅: qqrq
俚: lirl
俣: yurt
俜: pkrv
俑: ysry
俟: qiru
俸: fgrl
倩: qmro
偌: rork
俳: pdrf
倬: voru
倏: uurq
倮: lorg
倭: worn
俾: biru
倜: tirk
倌: grrk
倥: ksrg
倨: jurk
偾: ffrr
偃: yjrn
偕: xprb
偈: jprv
偎: wwrn
偬: zsrx
偻: lzrn
傥: thre
傧: bbrb
傩: norf
傺: iirx
僖: xirk
儆: jkrw
僭: jmro
僬: jnrh
僦: jqry
僮: vlrl
儇: xrry
儋: djrk
仝: tsrg
佘: uerx
佥: qmra
俎: zurq
龠: ytrc
汆: crru
籴: dirm
兮: xibv
巽: xysb
黉: hsxb
馘: goba
冁: ijbn
夔: kvbw
匍: pubf
訇: hsbk
匐: fubt
凫: fupj
夙: sujd
兕: siae
兖: yjwe
亳: bowq
衮: gywy
袤: mcwy
亵: xpwy
脔: lrwr
裒: pzwy
禀: bkwx
嬴: ykwf
蠃: lowf
羸: lwwf
冱: hudh
冽: lpdd
冼: xmde
凇: ssds
冢: vsbn
冥: mkbb
讦: jpyg
讧: hsyg
讪: ujye
讴: ouyx
讵: juyj
讷: neyn
诂: guyk
诃: heyk
诋: diyd
诏: vcyk
诎: quyi
诒: yiyk
诓: klyw
诔: lwyl
诖: gxyt
诘: jpyk
诙: hvyh
诜: ufye
诟: gzyk
诠: qryw
诤: vgyl
诨: hyyi
诩: xuyx
诮: qnyo
诰: gcyk
诳: klyw
诶: eiyu
诹: zzyy
诼: voyn
诿: wwyn
谀: yuyy
谂: ufyx
谄: ijyj
谇: svyu
谌: ufyv
谏: jmyj
谑: xtya
谒: yeyv
谔: eeyk
谕: yuyd
谖: xryy
谙: anyo
谛: diyj
谝: pmyc
谟: moyd
谠: dhye
谡: suyw
谥: uiym
谧: miym
谪: veyk
谫: jmyd
谮: zfyo
谯: qnyh
谲: jtyk
谳: yjyq
谵: vjyk
谶: ifyj
卺: jblv
阡: qmeq
阱: jkej
阪: bjey
阽: dmek
阼: zoev
陂: poey
陉: xkeg
陔: gder
陟: viep
陧: npet
陬: zzey
陲: ivei
陴: pieu
隈: wwen
隍: hlew
隗: wweg
隰: xieh
邗: hjge
邛: qsge
邝: klge
邙: mhwe
邬: wuwe
邡: fhfe
邴: bkbe
邳: pipe
邶: bwle
邺: yeye
邸: dide
邰: tdse
郏: jxje
郅: viae
邾: vuve
郐: kkre
郄: xixe
郇: xybe
郓: yybe
郦: lile
郢: ykke
郜: gcne
郗: xixe
郛: fupe
郫: pipe
郯: tjhe
郾: yjke
鄄: jrxe
鄢: yjve
鄞: ybne
鄣: vhle
鄱: pope
鄯: ujye
鄹: zzee
酃: lkye
酆: fgfe
刍: iude
奂: hrdd
劢: mdwl
劬: qubl
劭: ucdl
劾: hewl
哿: gelk
勐: mgzl
勖: xukl
勰: xplx
叟: szpy
燮: xpwy
矍: jtoy
凼: dhuk
鬯: ihxb
弁: bmsc
畚: bfst
巯: qqvv
坌: bfbt
垩: eeyt
垡: fart
塾: uuwt
墼: jiit
壅: yswt
壑: helt
圩: xuty
圬: wutk
圪: getq
圳: vfti
圹: kltg
圮: pitj
圯: yits
坜: litl
圻: ybtj
坂: bjty
坩: gjtg
坫: dmtk
垆: lutu
坼: ieti
坻: iitd
坨: totb
坭: nitb
坳: aotl
垭: yaty
垤: dptt
垌: dstk
垲: kdtj
埏: yjtz
垧: uhtk
垴: nctk
垓: gdtr
垠: ybtg
埕: igtw
埘: uitc
埚: gotn
埙: xytr
埒: lptc
垸: hrte
埴: vitq
埯: antd
埸: yitw
埤: pitu
埝: nmtx
堋: pgto
堍: tutd
埽: sctj
埭: ddtn
堞: dptm
堙: ybtt
塄: lgtf
堠: hztu
塥: getl
塬: yrtx
墁: mjty
墉: ystl
墚: lltm
墀: iitn
馨: xbuo
鼙: piuu
懿: yiux
艽: qqcj
艿: ndcn
芏: duct
芊: qmcq
芨: jicj
芄: wjcw
芎: xscg
芑: qicj
芗: xlcx
芙: fucf
芫: yrce
芸: yycs
芾: fwcl
芰: jicy
苈: licl
苊: eecv
苣: jucj
芘: bicb
芷: vicv
芮: rvcn
苋: xmce
苌: ihci
苁: cscr
芩: qbcv
芴: wucw
芡: qmcr
芪: qicu
芟: ujcy
苄: bmcb
苎: vuca
芤: kzcv
苡: yicr
茉: mocm
苷: gjcg
苤: ppcp
茏: lscl
苜: muco
苴: jucq
苒: rjcr
苘: qkck
茌: iicu
苻: fucc
苓: lkcs
茑: nncn
茚: ybce
茆: mcce
茔: ykct
茕: qscu
苠: mbcm
苕: ucck
茜: xicx
荑: yicy
荛: rccw
荜: bicu
茈: zicb
莒: juck
茼: tsck
茴: hvck
茱: vucv
莛: tkcz
荞: qncl
茯: fucq
荏: rfcr
荇: xkci
荃: qrcw
荟: hvcs
荀: xyco
茗: mkck
荠: qicl
茭: jncx
茺: isce
茳: jlcg
荦: locn
荥: ykcu
荨: xycc
茛: gfcg
荩: jbcd
荬: mdcd
荪: sycx
荭: hscg
荮: vzcc
莰: kjcr
荸: bicz
莳: uicc
莴: wocn
莠: yzcn
莪: eecw
莓: mwcm
莜: yzcw
莅: licl
荼: tuch
莶: xmca
莩: fucz
荽: svcn
莸: yzcy
荻: dich
莘: xbcu
莞: grce
莨: lhcl
莺: ykcn
莼: iyct
菁: jkco
萁: qicb
菥: xicj
菘: sscs
堇: jbna
萘: ndcx
萋: qicn
菝: bacd
菽: uucy
菖: ihco
萜: tpck
萸: yucy
萑: hrcf
萆: bicu
菔: fucy
菟: tucd
萏: djcj
萃: cvcu
菹: zucq
菪: dhcu
菅: jmck
菀: yycv
萦: ykcx
菰: gucg
菡: hjck
葜: qxcd
葑: fgcc
葚: ufcv
葙: xlco
葳: wwcn
蒇: ijcr
蒈: kdcb
葺: qice
蒉: kvcr
葸: xicx
萼: eeck
葆: bccm
葩: pacb
葶: tkcd
蒌: lzcn
蒎: pdcn
萱: xrcg
葭: jxcy
蓁: vfch
蓍: uico
蓐: rucc
蓦: mocm
蒽: encx
蓓: bwck
蓊: wgcx
蒿: hcck
蒺: jicu
蓠: licd
蒡: bhcf
蒹: jmcn
蒴: uoco
蒗: lhcl
蓥: ykcj
蓣: yucr
蔌: sucr
甍: mgcw
蔸: dzce
蓰: xicr
蔹: lmcw
蔟: cucu
蔺: lbcf
蕖: qucm
蔻: kzcy
蓿: xucb
蓼: lucp
蕙: hvcx
蕈: xycu
蕨: jtcr
蕤: rvcu
蕞: zvcy
蕺: jica
瞢: mgco
蕃: fjct
蕲: qicj
蕻: hscb
薤: xpcj
薨: hscb
薇: wwcw
薏: yicx
蕹: wgcf
薮: szcw
薜: bicu
薅: hccc
薹: tdct
薷: ruce
薰: xych
藓: xmcy
藁: gccm
藜: licu
藿: hocf
蘧: qucz
蘅: hgci
蘩: fjcx
蘖: npcm
蘼: micf
弈: yiwc
夼: kldi
奁: lmdx
耷: dade
奕: yiwd
奚: xipd
奘: zhpd
匏: pcds
尢: yzuv
尥: lnuu
尬: gayl
尴: gjym
扪: mffm
抟: trfv
抻: iffu
拊: fufc
拗: nqfl
拮: jxfk
拶: zjfx
挹: yifb
捋: lvfc
捃: jyfk
掭: tmfx
揶: yefe
捱: aift
捺: nafx
掎: jifk
掴: gofy
捭: bdfu
掬: jufm
掊: pzfk
捩: lpfq
掮: qmfo
掼: grfr
揸: vafd
揠: yafn
揿: qbfr
揄: yufd
摒: bkfk
揆: kvft
掾: yrfu
摅: uufx
摁: enfx
搋: ikfj
搛: jmfn
搠: uofo
搌: vjfn
搦: nofd
搡: shfm
摞: lofx
撄: ykfn
摭: vifh
撖: hjfw
撷: xpfr
撸: lufo
撙: zyfc
撺: crfi
擀: gjfg
擐: hrfy
擤: xkfl
擢: voff
攉: hoff
攥: zrfx
攮: nhfy
弋: yiad
忒: tvyx
弑: uixg
卟: bukb
叱: iikb
叽: jikj
叩: kzke
叨: tckd
叻: lekl
吒: vakq
吖: yaky
吆: ycky
呋: fukf
呒: omkw
呓: yikv
呔: tdkt
呖: likl
呃: eekv
吡: pikb
呗: bwkr
呙: wokn
吣: qbkx
吲: ybky
咂: zakj
咔: kakb
呷: xxkj
呱: gxkg
呤: lkks
咚: dskd
咛: nkkd
咄: doki
呶: ncky
呦: yzkl
咝: siks
哐: klkw
哂: ufkx
咴: hvkh
哒: dakz
咧: lpkd
咦: yiky
哓: xnkw
哔: biku
呲: zikb
咣: glkw
哕: hvkx
咻: xqkm
咿: yiky
哌: pdkn
哙: kkks
哚: dokm
咩: mpky
咪: mikm
咤: vakq
哝: nskn
哏: hfkg
哞: mzkn
唛: mdkw
哧: iikd
唠: lckl
哽: ggkg
唔: wukk
哳: vakj
唢: sokr
唣: zckq
唏: xikj
唑: zokt
唧: jike
唪: fgkl
啧: zekr
喏: rekk
喵: mnkt
啉: ljkm
啭: vrkv
啁: vzkk
啕: tckf
唿: hukx
啐: qiku
唼: uakn
唷: yoko
啖: djkh
啵: boky
啶: dkkr
啷: lhke
唳: likq
唰: uxkd
啜: ioky
喋: vakm
嗒: takk
喃: njkg
喱: likl
喹: kvkt
喈: jpkb
喁: ysky
喟: kvko
啾: jqkh
嗖: szky
喑: ybko
啻: iiwk
嗟: jpkg
喽: lzkn
喾: kuxk
喔: wokt
喙: hvku
嗪: qbkh
嗷: aokw
嗉: sukx
嘟: duke
嗑: kekm
嗫: npky
嗬: hekk
嗔: ifkb
嗦: sokx
嗝: gekl
嗄: uakw
嗯: enkx
嗥: hcku
嗲: dxkx
嗳: aiky
嗌: yikm
嗍: soko
嗨: hdkm
嗵: tskz
嗤: iiki
辔: pwsk
嘞: lwkl
嘈: ccko
嘌: pnkx
嘁: qikx
嘤: ykkn
嘣: bgko
嗾: szku
嘀: dikk
嘧: mike
嘭: pgkp
噘: jtkr
嘹: lnkx
噗: pukn
嘬: zoky
噍: jnkh
噢: ookd
噙: qbkd
噜: luko
噌: cgko
噔: dgka
嚆: hckk
噤: jbkx
噱: xtku
噫: yikx
噻: sdkt
噼: piku
嚅: ruke
嚓: iakx
嚯: hokf
囔: nhky
囝: jmkz
囡: njkn
囵: lykb
囫: hukw
囹: lkks
囿: yzko
圄: yukk
圊: qkko
圉: yukg
圜: yrky
帏: wwjw
帙: viju
帔: pwjy
帑: nunj
帱: izjc
帻: zejr
帼: gojy
帷: wwjf
幄: wojt
幔: mjjy
幛: vhju
幞: fujn
幡: fjjt
岌: jiej
屺: qiej
岍: qmek
岐: qiey
岖: quex
岈: yaey
岘: xmee
岙: aoye
岑: cfe
岚: ljex
岜: baeb
岵: huek
岢: keek
岽: dsed
岬: jxej
岫: xqey
岱: ddre
岣: gzek
峁: mcee
岷: mbem
峄: yiel
峒: tsek
峤: jnel
峋: xyeo
峥: vgel
崂: lcel
崃: ldel
崧: sses
崦: yjed
崮: guek
崤: xneo
崞: goez
崆: kseg
崛: jtei
嵘: rsem
崾: ycen
崴: wwen
崽: zdex
嵬: wweg
嵛: yued
嵯: coeg
嵝: lzen
嵫: ziey
嵋: mweo
嵊: ugen
嵩: ssek
嵴: jieo
嶂: vheu
嶙: lbel
嶝: dgea
豳: bbuu
嶷: yier
巅: dmer
彳: iipr
彷: fhif
徂: cuiq
徇: xyio
徉: yhiy
徕: ldil
徙: xiir
徜: ihik
徨: hliw
徭: ycif
徵: viiw
徼: jniw
衢: quii
犰: qqqj
犴: hjqg
犷: glqg
犸: maqm
狃: nqqi
狁: yyqe
狎: xxqj
狍: pcqs
狒: fwqf
狨: rsqu
狯: kkqs
狩: uzqc
狲: syqx
狴: biqt
狷: jrqo
猁: liqd
狳: yuqh
猃: xmqa
狺: ybqk
狻: srqw
猗: yiqk
猡: loqx
猊: niqe
猞: ueqk
猝: cuqu
猕: miqx
猢: huqo
猹: iaqd
猥: wwqn
猬: wwqo
猱: ncqm
獐: vhqu
獍: jkqe
獗: jtqr
獠: lnqx
獬: xpqn
獯: xyqh
獾: hrqf
舛: irxl
夥: hogx
飧: syxl
夤: ybxb
饧: xkup
饨: tyut
饩: xiuq
饪: rfur
饫: yuuy
饬: iiul
饴: yiuk
饷: xluk
饽: bouz
馄: hyub
馇: iaud
馊: szuy
馍: moud
馐: xqui
馑: jbua
馓: sjuw
馔: vrub
馕: nhuy
庑: wugw
庋: gvgy
庖: pcgs
庥: xqgm
庠: xlgy
庹: togi
庵: angd
庾: yugy
庳: bwgu
赓: gggr
廒: aogw
廑: qbga
廛: ijgt
廨: xpgn
廪: lbgx
膺: ykgo
忉: dcxd
忖: cyxc
忏: ijxq
怃: wuxw
忮: vixy
怄: ouxx
忡: isxv
忤: wuxw
忾: xixq
怅: ihxi
怆: ilxv
忪: vsxs
忭: bmxb
忸: nqxi
怙: huxk
怵: iuxu
怦: pgxp
怛: daxd
怏: yhxy
怍: zoxv
怩: nixb
怫: fuxf
怊: icxk
怿: yixl
怡: yixk
恸: tsxl
恹: yjxq
恻: cexd
恺: kdxj
恂: xyxo
恪: kexk
恽: yyxi
悖: bwxz
悚: ssxu
悭: qmxt
悝: lixl
悃: kyxm
悒: yixb
悌: tixp
悛: qrxw
惬: qpxj
悻: xkxg
悱: fwxf
惝: thxk
惘: whxw
惆: izxk
惚: huxx
悴: cvxu
愠: yyxm
愦: kvxr
愕: eexk
愣: lgxf
惴: vvxe
愀: qnxh
愎: bixw
愫: suxx
慊: qpxn
慵: ysxl
憬: jkxx
憔: qnxh
憧: isxl
憷: iuxr
懔: lbxx
懵: mgxo
忝: tmtx
隳: doex
闩: urma
闫: yjms
闱: wwmw
闳: hsms
闵: mbmw
闶: khmj
闼: tamz
闾: lvmk
阃: kymm
阄: jqmv
阆: lhml
阈: yuma
阊: ihmo
阋: xime
阌: wfmy
阍: hymo
阏: eemd
阒: qumq
阕: qtmt
阖: hemm
阗: tmmb
阙: qtmr
阚: kjmw
爿: pjvp
戕: qlpg
汔: qidq
汜: sids
汊: iadi
沣: fgdf
沅: yrde
沐: mudm
沔: mmdv
沌: dydt
汨: mido
汩: yudo
汴: bmdb
汶: wfdw
沆: hhdj
沩: wwdw
泐: ledl
泔: gjdg
沭: uudu
泷: lsdl
泸: ludu
泱: yhdy
泗: side
泠: lkds
泖: mcde
泺: lodl
泫: xrdy
泮: pjdb
沱: todb
泓: hsds
泯: mbdm
泾: jkdg
洹: hrdg
洧: wwdo
洌: lpdd
浃: jxdj
浈: vfdr
洇: ybdd
洄: hvdk
洙: vudv
洎: jidz
洫: xudx
浍: hvds
洮: tcdd
洵: xydo
洚: jldl
浏: lqdd
浒: xudw
浔: xydc
洳: rudk
涑: sudu
浯: wudk
涞: lddl
涠: wwdw
浞: vodr
涓: jrdo
涔: cfdv
浜: bhdb
浠: xidj
浼: mwdv
浣: hrde
渚: vudo
淇: qidb
淅: xidj
淞: ssds
渎: dudd
涿: vodn
淠: pidl
渑: ugdd
淦: gjdj
淝: fwdb
淙: csdx
涫: grdk
渌: ludu
涮: urdd
渫: xpdm
湮: yjdt
湎: mmdm
湫: qqdh
溲: szdy
湟: hldw
溆: xudy
湓: pfdm
湔: jmdd
渲: xrdg
渥: wodt
湄: mwdo
滟: yjdb
溱: vfdh
溘: kedm
滠: uedy
漭: mhdc
滢: ykdy
溥: pudc
溧: lidm
溽: rudc
溻: tadx
溷: hydu
滗: bidm
溴: xqdq
滏: fuda
溏: thdk
滂: phdf
溟: mkdb
潢: hldb
潆: ykdx
潇: xnds
漤: ljdn
漕: ccdo
滹: hudh
漯: tadx
漶: hrdx
潋: lmdw
潴: vudo
漪: yidk
漉: ludb
漩: xrdr
澉: gjdw
澍: vudc
澌: sidj
潸: ujdo
潲: ucdo
潼: tsdl
潺: ijdz
濑: lddr
濉: svdf
澧: lida
澹: djdk
澶: ijdd
濂: lmdn
濡: rude
濮: pudn
濞: pidl
濠: hcdu
濯: vodf
瀚: hjdx
瀣: xpdj
瀛: ykdf
瀹: ytdc
瀵: ffdb
灏: hcdr
灞: bado
宄: gvbj
宕: dhbu
宓: mibb
宥: yzbo
宸: ifbn
甯: nkby
骞: qmbm
搴: qmbu
寤: wubk
寮: lnbx
褰: qmby
寰: hrby
蹇: jmbr
謇: jmbk
迓: yazy
迕: wuzw
迥: jszk
迮: zezv
迤: yizy
迩: erzx
迦: jxzk
迳: jkzg
迨: ddzk
逅: hzzk
逄: phzl
逋: buzf
逦: lizl
逑: qqzq
逍: xnzo
逖: tizh
逡: qyzw
逵: kvzt
逶: wwzn
逭: hrzk
逯: luzu
遄: irze
遑: hlzw
遒: qqzy
遐: xxzy
遨: aozw
遘: gzzr
遢: tazx
遛: lqzt
暹: xmzf
遴: lbzl
遽: juzu
邂: xpzn
邈: mnze
邃: svzu
邋: lazv
彗: hvfe
彖: trvu
彘: vivb
尻: kcuj
咫: viib
屐: jiuy
屙: eeuk
孱: ijuz
屣: xiur
屦: juun
羼: ijuy
弩: nung
弭: mige
艴: fufb
弼: bigg
鬻: yugl
妁: uonu
妃: fwnj
妍: yjnk
妩: wunw
妪: yunx
妣: binb
妗: jbnv
姊: zinp
妫: gvnw
妞: nqni
妤: yunl
姒: sinr
妲: dand
妯: vzny
姗: ujnc
妾: qpln
娅: yany
娆: rcnw
姝: uunv
娈: lrwn
姣: xnnx
姘: pbnk
姹: ianq
娌: linl
娉: pknv
娲: wann
娴: xmnm
娑: sodn
娣: dinp
娓: wwnm
婀: eenk
婧: jkno
婊: bnny
婕: jpnr
娼: ihno
婢: binu
婵: ijnl
胬: nunr
媪: aonm
媛: yrny
婷: tknd
婺: wusn
媾: gznr
嫫: mond
媲: pinb
嫒: ainy
嫔: pbnb
媸: iini
嫠: liwn
嫣: yjnh
嫱: qlnk
嫖: pnnx
嫦: ihnj
嫘: lwnx
嫜: vhnu
嬉: xink
嬗: ujnd
嬖: biun
嬲: nntl
嬷: monm
孀: ulno
尕: ganx
尜: gaxx
孚: fupz
孥: nunz
孳: zibz
孑: jpva
孓: jtvn
孢: bczs
驵: zhmq
驷: sime
驸: fumc
驺: zzme
驿: yiml
驽: nunm
骀: tdmk
骁: xnmw
骅: hxmu
骈: pmmk
骊: liml
骐: qimb
骒: kemg
骓: vvmf
骖: cjmp
骘: viem
骛: wusm
骜: aofm
骝: lqmt
骟: ujmx
骠: pnmx
骢: csmx
骣: ijmz
骥: jimb
骧: xlmy
纡: yusy
纣: vzsc
纥: hesq
纨: wjsw
纩: klsg
纭: yyss
纰: pisb
纾: uusl
绀: gjsg
绁: xpsu
绂: fusd
绉: vzse
绋: fusf
绌: iusi
绐: ddsk
绔: kusk
绗: hhsi
绛: jlsl
绠: ggsg
绡: xnso
绨: tisp
绫: lksw
绮: qisk
绯: fwsf
绱: uhsk
绲: gysb
绶: uzsy
绺: lqsk
绻: qrsv
绾: wjsk
缁: zist
缂: kesg
缃: xlso
缇: tisr
缈: mnsu
缌: sisx
缑: gzsu
缒: vvsz
缗: mbso
缙: jbso
缜: vfsb
缛: rusc
缟: gcsk
缡: lisd
缢: yism
缣: jmsn
缤: bbsb
缥: pnsx
缦: mjsy
缧: lwsx
缪: mzsp
缫: scsg
缬: xpsr
缭: lnsx
缯: zgso
缰: jlsa
缱: qmsz
缲: scsm
缳: hrsy
缵: zrsr
幺: ycvs
畿: jiyt
甾: zdvt
邕: ysvb
玎: dkwd
玑: jiwj
玮: wwww
玢: ffwd
玟: wfww
珏: jtwy
珂: kewk
珑: lswl
玷: dmwk
玳: ddwy
珀: powb
珉: mbwm
珈: jxwk
珥: erwe
珙: gswb
顼: xuwr
琊: yawe
珩: hhwi
珧: ycwd
珞: lowk
玺: xidy
珲: hywi
琏: lmwz
琪: qiwb
瑛: ykwy
琦: qiwk
琥: huwj
琨: kywb
琰: yjwh
琮: cswx
琬: wjwv
琛: ifwm
琚: juwk
瑁: mcwo
瑜: yuwd
瑗: yrwy
瑕: xxwy
瑙: ncwx
瑷: aiwy
瑭: thwk
瑾: jbwa
璜: hlwb
璎: ykwn
璀: cvwf
璁: cswx
璇: xrwr
璋: vhwu
璞: puwn
璨: cjwm
璩: quwu
璐: luwk
璧: biuy
瓒: zjwr
璺: wfpy
韪: wwow
韫: yywm
韬: tcwj
杌: wumw
杓: ucmu
杞: qimj
杈: iami
杩: mamm
枥: liml
枇: pimb
杪: mnmu
杳: ycmo
枘: rvmn
枧: jmme
杵: iumw
枨: igmi
枞: zsmr
枭: xnpm
枋: fhmf
杷: pamb
杼: vuml
柰: ndmx
栉: vime
柘: vemu
栊: lsml
柩: jqmj
枰: pkmp
栌: lumu
柙: xxmj
枵: xnmv
柚: yzmy
枳: vimb
柝: tomi
栀: vimv
柃: lkms
枸: gzmk
柢: dimd
栎: ytml
柁: tomb
柽: igmt
栲: kcmv
栳: lcmb
桠: yamy
桡: rcmw
桎: vimt
桢: vfmr
桄: glmw
桤: qimj
梃: tkmz
栝: gxmk
桕: jqmj
桦: hxmu
桁: hhmi
桧: hvms
桀: jpxm
栾: lrwm
桊: jrjm
桉: anmn
栩: xumx
梵: fjmf
梏: gumk
桴: fumz
桷: jtmy
梓: zimu
桫: somu
棂: lkmh
楮: iumo
棼: ffmd
椟: dumd
椠: qmim
棹: vcmu
椤: lomx
棰: ivmi
椋: llmx
椁: gomz
楗: jmmz
棣: timn
椐: jumk
椹: vfmv
楠: njmg
楂: vamd
楝: lmmj
榄: ljme
楫: jime
楸: qqmh
椴: drmy
槌: ivmz
榇: ifmm
榈: lvmk
槎: iamg
榉: juml
楦: xrmg
楣: mwmo
楹: ykmm
榛: vfmh
榧: fwmf
榻: tamx
榫: symu
榭: xpmc
槔: gcmu
榱: cvmy
槁: gcmk
槊: uobm
槟: bkmb
榕: rsmk
槠: vumo
榍: xpmo
槿: jbma
樯: qlmk
槭: qimx
樗: iumk
樘: thmt
橥: vuqm
槲: humu
橄: gjmw
樾: ytmv
檠: qkcm
橐: toam
橛: jtmr
樵: qnmh
檎: qbmd
橹: lumo
樽: zymc
樨: ximn
橘: jumk
橼: yrmu
檑: lwmt
檐: yjmk
檩: lbmx
檗: boum
檫: iamx
猷: yzbq
獒: aofq
殁: mody
殂: cudq
殇: uhdp
殄: tmdp
殒: yydr
殓: lmda
殍: pndz
殚: djdl
殛: jida
殡: bbdb
殪: yida
轫: rfir
轭: eeiv
轱: guik
轲: keik
轳: luiu
轵: viib
轶: yiiu
轸: vfip
轷: huih
轹: liil
轺: ycik
轼: uiig
轾: viit
辁: qriw
辂: luik
辄: veiv
辇: nmfi
辋: whiw
辍: ioiy
辎: ziit
辏: czit
辘: luib
辚: lbil
戋: jmad
戗: qlrg
戛: jxag
戟: jiug
戢: jikd
戡: kjqg
戥: dgog
戤: gdng
戬: jmyg
臧: zhad
瓯: oukw
瓴: lkrw
瓿: bulw
甏: bguw
甑: zgbw
甓: piuw
旮: gajo
旯: laoj
旰: gjog
昊: hcot
昙: tjos
杲: gcom
昃: zeor
昕: xboj
昀: yyod
炅: jsoh
曷: heov
昝: zjwo
昴: mcoe
昱: yuol
昶: ihyo
昵: niob
耆: qilo
晟: ugoi
晔: yeou
晁: icod
晏: yjon
晖: hvoi
晡: buof
晗: hjok
晷: gvok
暄: xrog
暌: kvot
暧: aioy
暝: mkob
暾: tyow
曛: xyoh
曜: ycof
曦: xiod
曩: nhoy
贲: biur
贳: uiur
贶: klke
贻: yikk
贽: vifr
赀: zivr
赅: gdkr
赆: jbkd
赈: vfkn
赉: ldlr
赇: qqkq
赍: jiur
赕: djkh
赙: fukc
觇: ijle
觊: jiee
觋: xige
觌: diue
觎: yure
觏: gzje
觐: jbne
觑: quhe
牮: jmrn
犟: jlgn
牝: pbnb
牦: mcnm
牯: gunk
牾: wunk
牿: gunk
犄: jink
犋: junb
犍: qmnz
犏: pmnc
犒: kcnk
挈: qpfu
挲: uadu
掰: bduu
擘: bouu
耄: mclm
毪: mumn
毳: cvmm
毽: jmmz
毵: sjsm
毹: uurm
氅: ihxm
氇: lumo
氆: pumo
氍: quom
氕: ppqp
氘: dcql
氙: xmqe
氚: irqi
氡: dsqd
氩: yaqy
氤: ybqd
氪: keqe
氲: yyqm
敕: iiuw
敫: jnbw
牍: dupd
牒: dppm
牖: yzpf
爰: yrpy
虢: gopj
刖: ytod
肟: wook
肓: hlwo
肼: jkoj
肽: tdot
肱: gsos
肫: vyot
肭: naon
肴: ycxo
肷: qmor
胧: lsol
胨: dsod
胩: kaob
胪: luou
胛: jxoj
胂: ufou
胄: vzyo
胙: zoov
胍: gxog
胗: vfop
朐: quok
胝: viod
胫: jkog
胱: glow
胴: dsok
胭: yjod
脍: kkos
脎: saom
胲: hdor
胼: pmok
朕: vfot
脒: miom
豚: tyou
脶: loon
脞: coot
脬: pcoz
脘: wjoe
脲: nnou
腈: jkoo
腌: yjod
腓: fwof
腴: yuoy
腙: zsox
腚: dkor
腱: jmoz
腠: czot
腩: njog
腼: mmom
腽: waom
腭: eeok
腧: uuod
塍: igot
媵: ykon
膈: geol
膂: lvfo
膑: bbob
滕: tgou
臌: guoy
朦: mgon
臊: scom
膻: ujod
膦: lbol
欤: yuyr
欹: qidr
歃: uaqr
歆: xblr
歙: xirr
飑: bnjs
飒: salx
飓: jujb
飕: szjy
飙: bnqx
殳: uujy
彀: gzuy
毂: guuy
觳: huuy
斐: fwfw
齑: jiwl
斓: ljwj
於: yufd
旆: pwfl
旄: mcfm
旃: vjfd
旌: jkfu
旎: nifb
旒: lqfv
旖: yifk
炀: yhhp
炜: wwhw
炖: dyht
炝: qlhv
炻: uihu
烀: huhh
炷: vuhv
炫: xrhy
炱: tdsh
烨: yehu
烊: yhhy
焐: wuhk
焓: hjhk
焖: mfhx
焯: vohu
焱: yjhh
煳: huho
煜: yuhl
煨: wwhn
煅: drhy
煲: bcrh
煊: xrhg
煸: bmhc
煺: tvhz
熘: lqht
熵: uhhk
熨: yyuh
熠: yihb
燠: yuhd
燔: fjht
燧: svhz
燹: xmuh
爝: jthc
爨: crph
焘: tcfh
煦: xuoh
熹: xiuh
戾: lihq
戽: huhu
扃: jshk
扈: huhb
扉: fwhf
祀: sips
祆: xmpt
祉: vipv
祛: qups
祜: hupk
祓: fupd
祚: zopv
祢: mipx
祗: vipd
祠: cipk
祯: vfpr
祧: tnpd
祺: qipb
禅: ujpl
禊: xipd
禚: voph
禧: xipk
禳: rhpy
忑: texx
忐: tjux
怼: dvyx
恝: jxfx
恚: hvtx
恧: nvex
恁: nfrx
恙: yhyx
恣: zidx
悫: qtux
愆: qmix
愍: mbmx
慝: tekx
憩: qiqx
懋: mcmx
懑: mfdx
戆: vllx
聿: yuvl
沓: tauo
淼: mnuu
矶: jiuj
矸: gjug
砀: dhup
砉: xufu
砗: ieui
砘: dyut
砑: yauy
斫: vouj
砭: bmuf
砜: fgux
砝: faus
砹: aiux
砺: liuw
砻: lslu
砟: vauv
砼: tsug
砥: diud
砬: liul
砣: toub
硎: xkud
硭: mhuw
硖: xxuj
硗: qnuw
硐: dsuk
硇: ncux
硌: louk
硪: wouw
碛: qiur
碓: dvuf
碚: bwuk
碇: dkur
碜: ifup
碡: vzum
碣: yauv
碲: diuj
碹: xrug
碥: bmuc
磔: veum
磙: gyuy
磉: shum
磬: qkuu
磲: quum
礅: dyuw
磴: dgua
礓: jlua
礞: mgun
礴: bouc
龛: kjrl
黹: viyd
黻: fuyd
黼: fuyf
盱: xuoy
眄: mmom
眍: kzox
盹: dyot
眇: mnou
眈: djov
眚: uguo
眢: yrxo
眙: yiok
眭: svot
眦: ziob
眵: iiox
眸: mzon
睐: ldol
睑: jmoa
睇: diop
睃: soow
睚: yaot
睨: nioe
睢: hvof
睥: piou
睿: rvlo
瞍: szoy
睽: kvot
瞀: mcso
瞌: keom
瞑: mkob
瞟: pnox
瞠: igot
瞰: kjow
瞵: lbol
瞽: guuo
町: tktd
畀: bitl
畎: qrtq
畋: tmtw
畈: fjty
畛: vftp
畲: uert
畹: wjtv
疃: trtl
罘: fusb
罡: ghsv
罟: gusk
詈: lisk
罨: yjsd
罴: pish
罱: ljsg
罹: lisf
羁: jism
罾: zgso
盍: hetm
盥: grpm
蠲: jrbi
钆: gajv
钇: yijv
钋: pojb
钊: vcjd
钌: lnjl
钍: tujt
钏: irji
钐: ujjp
钔: mfjm
钗: idji
钕: nvjn
钚: bujb
钛: tdjt
钜: jujj
钣: bjjy
钤: qmjv
钫: fhjf
钪: khjj
钭: dzju
钬: hojh
钯: bajb
钰: yujy
钲: vgjv
钴: gujk
钷: pojk
钹: bojd
钺: ytjv
钼: mujo
钽: tjjd
钿: tmjt
铄: uojl
铈: uijj
铉: xrjy
铊: tajb
铋: bijb
铌: nijb
铍: pijy
铎: dojl
铐: kcjv
铑: lcjb
铒: erje
铕: yzjo
铖: igji
铗: jxjj
铙: ncjw
铘: yeje
铛: igje
铞: dnjj
铟: ybjd
铠: kdjj
铢: vujv
铤: tkjz
铥: dqjs
铧: hxju
铨: qrjw
铪: kejk
铩: uajm
铫: tnjd
铮: vgjl
铯: sejb
铳: isje
铴: thjp
铵: anjn
铷: rujk
铹: lcjl
铼: ldjl
铽: tejx
铿: kgjt
锃: zgjw
锂: lijl
锆: gcjk
锇: eejw
锉: cojt
锊: ltjc
锍: lqjv
锎: kdjk
锏: jmjo
锒: lhjl
锓: qbjy
锔: jujk
锕: aajk
锖: qljo
锘: nojk
锛: bfjc
锝: dejc
锞: kejg
锟: kyjb
锢: gujk
锪: hojx
锫: pwjk
锩: jrjv
锬: tjjh
锱: zijt
锲: qpjd
锴: kdjb
锶: sijx
锷: eejk
锸: iajj
锼: szjy
锾: hrjy
锿: aijy
镂: lzjn
锵: qljc
镄: fwjr
镅: mwjo
镆: mojd
镉: gejl
镌: jrjn
镎: naju
镏: lqjt
镒: yijm
镓: jxju
镔: bbjb
镖: bnjx
镗: thjt
镘: mjjy
镛: ysjl
镞: zuju
镝: dijk
镡: xbju
镢: jtjr
镤: pujn
镥: lujo
镦: dvjw
镧: ljjj
镨: pujo
镩: crji
镪: qlji
镫: dgja
镬: hojy
镯: voji
镱: yijx
镲: iajx
镳: bnjh
锺: vsjv
矧: ufuy
矬: cout
雉: viuf
秕: bihb
秭: zihp
秣: mohm
秫: uuhu
稆: lvhk
嵇: jihe
稃: fuhz
稂: lhhl
稞: kehg
稔: rfhx
稹: vfhb
稷: jihw
穑: sehk
黏: nmhk
馥: fuhw
穰: rhhy
皈: gvby
皎: jnbx
皓: hcbk
皙: ximb
皤: pobt
瓞: dpgu
瓠: hudg
甬: yssy
鸠: jqjn
鸢: yryn
鸨: bcbn
鸩: vfdn
鸪: guun
鸫: dsdn
鸬: luln
鸲: qubn
鸱: iidn
鸶: sivn
鸸: eren
鸷: vifn
鸹: gxqn
鸺: xqrn
鸾: lrwn
鹁: boun
鹂: liln
鹄: hunn
鹆: yubn
鹇: xmmn
鹈: tibn
鹉: wuan
鹋: mncn
鹌: andn
鹎: bwpn
鹑: iywn
鹕: huun
鹗: eekn
鹚: cibn
鹛: mwvn
鹜: wusn
鹞: ycpn
鹣: jmbn
鹦: ykkn
鹧: vegn
鹨: lqxn
鹩: lndn
鹪: jnrn
鹫: jqwn
鹬: yusn
鹱: huny
鹭: luzn
鹳: grcn
疔: dkbd
疖: jpbe
疠: libw
疝: ujbe
疬: libl
疣: yzby
疳: gjbg
疴: kebk
疸: djbd
痄: vabv
疱: pcbs
疰: vubv
痃: xrby
痂: jxbk
痍: yiby
痣: vibx
痨: lcbl
痦: wubk
痤: cobt
痫: xmbm
痧: uabu
瘃: vubn
痱: fwbf
痼: gubk
痿: wwbn
瘐: yuby
瘀: yubd
瘅: djbl
瘌: labd
瘗: yibt
瘊: hzbu
瘥: idbg
瘘: lzbn
瘕: xxby
瘙: scbi
瘛: iibx
瘼: mobd
瘢: bjby
瘠: jibo
癀: hlbb
瘭: bnbx
瘰: lobx
瘿: ykbn
瘵: vdbx
癃: lsbu
瘾: ybbx
瘳: izbp
癍: bjbw
癞: ldbr
癔: yibx
癜: dmby
癖: pibu
癫: dmbr
癯: qubf
翊: yilx
竦: sslu
穸: xibx
穹: qsbg
窀: vybt
窈: ycbl
窕: tnbd
窦: dzbd
窠: kebg
窬: yubd
窨: ybbo
窭: jubn
窳: yubg
衩: iapi
衲: napn
衽: rfpr
衿: jbpv
袂: mwpg
袢: pjpb
裆: dhpe
袷: qxpk
袼: gepk
裉: kfpg
裢: lmpz
裎: igpw
裣: lmpa
裥: jmpo
裱: bnpy
褚: vupo
裼: xipw
裨: pipu
裾: jupk
裰: dopy
褡: dapk
褙: bwpo
褓: bcpm
褛: lvpn
褊: bmpc
褴: ljpm
褫: iipj
褶: vepb
襁: qlpi
襦: rupe
襻: pjpu
胥: xuvo
皲: jyby
皴: cysy
矜: qbsv
耒: lwan
耔: zilz
耖: iclu
耜: silk
耠: holk
耢: lcll
耥: thlk
耦: ouly
耧: lzln
耩: jllr
耨: nzlc
耱: molu
耋: dplt
耵: dked
聃: djer
聆: lkes
聍: nked
聒: goek
聩: kver
聱: aofe
覃: tjxu
顸: hjgr
颀: qijr
颃: hhwr
颉: xpur
颌: herr
颍: ykbr
颏: kewr
颔: hjrr
颚: eekr
颛: vrer
颞: nper
颟: mjcr
颡: shyr
颢: hcor
颥: ruyr
颦: pbvu
虔: qmhw
虬: qqiv
虮: jiij
虿: idwi
虺: hvwi
虼: geiq
虻: mgiw
蚨: fuif
蚍: piib
蚋: rvin
蚬: xmie
蚝: hcim
蚧: jpil
蚣: vsis
蚪: dziu
蚓: ybil
蚩: iivi
蚶: hjig
蛄: guik
蛎: liiw
蚰: yziy
蚺: rjir
蚱: vaiv
蚯: qqiq
蛉: lkis
蛏: igit
蚴: yzil
蛩: qsgi
蛱: jxij
蛲: nciw
蛭: viit
蛳: siij
蛐: quiq
蜓: tkiz
蛞: koik
蛴: qiil
蛟: jnix
蛘: yhiy
蛑: mzin
蜃: ufii
蜇: vefi
蛸: xnio
蜈: wuit
蜊: liid
蜍: iuih
蜉: fuiz
蜣: qliv
蜻: qkio
蜞: qiib
蜥: xiij
蜮: yuia
蜚: fwfi
蜾: goig
蝈: goiy
蜴: yiiw
蜱: piiu
蜩: tnik
蜷: qriv
蜿: wjiv
螂: lhie
蜢: mgim
蝽: iyio
蝾: rsim
蝻: njig
蝠: fuit
蝰: kvit
蝌: keiu
蝮: fuiw
螋: sziy
蝓: yuid
蝣: yziz
蝼: lzin
蝤: qqiy
蝙: bmic
蝥: mcsi
螓: qbih
螯: aofi
螨: mjil
蟒: mhic
蟆: maid
螈: yrix
螅: xiix
螭: iiid
螗: thik
螃: phif
螫: uiti
蟥: hlib
螬: ccio
螵: pnix
螳: thit
蟋: xiix
螽: vswi
蟑: vhiu
蟀: ukiu
蟊: mcsi
蟛: pgip
蟪: hvix
蟠: pjit
蟮: ujik
蠖: hoiy
蠓: mgin
蟾: ijik
蠊: lmin
蠡: livi
蠹: duai
蠼: quiy
缶: fzwk
罂: ykkf
罄: qkuf
罅: xxfh
舐: uiqu
竺: vuve
竽: yuvy
笈: jivj
笃: duvm
笄: jivk
笕: jmve
笊: vcvv
笫: zivp
笏: huvw
筇: qsve
笸: povk
笪: davd
笙: ugvu
笮: zevv
笱: gzvk
笠: livl
笥: sivk
笤: tnvk
笳: jxvk
笾: bmvz
笞: iivk
筘: kzvk
筚: bivu
筅: xmve
筵: yjvz
筌: qrvw
筝: vgvl
筠: yyvd
筮: uivr
筻: ghvg
筢: pavb
筲: ucvo
筱: xnvw
箐: qkvo
箦: zevr
箧: qpvj
箸: vuvo
箬: rovk
箨: tovl
箅: bivl
箪: djvl
箜: ksvg
箢: yrvv
箫: xnvs
箴: vfvk
篑: kvvr
篁: hlvw
篌: hzvu
篝: gzvr
篚: fwvf
篥: livm
篦: bivb
篪: iivj
簌: suvr
篾: mpvu
篼: dzve
簏: luvb
簖: drvj
簋: gvvm
簟: dmvu
簪: zjvo
簸: bovy
籁: ldvr
籀: vzvt
臾: yupn
舁: yujc
舂: isfj
舄: xijh
臬: npzm
衄: nvxi
舢: ujve
舣: yivy
舭: bivb
舯: vsvv
舫: fhvf
舸: gevk
舻: luvu
舳: vuvy
舴: zevv
舾: xivx
艄: ucvo
艉: wwvm
艋: mgvm
艏: uzvz
艚: ccvo
艟: isvl
艨: mgvu
衾: qbry
袅: nnpy
袈: jxly
裘: qqqy
裟: uady
襞: biuy
羝: diyd
羟: qlyg
羧: soyw
羯: jpyv
羰: thyh
羲: xiyd
籼: xmme
敉: mimw
粑: bamb
粝: limw
粜: tnim
粞: ximx
粢: cidm
粲: cjlm
粼: lbmv
粽: zsmx
糁: ufmp
糇: hzmu
糌: zjmo
糍: cimy
糈: xumo
糅: rzmm
糗: qqmq
糨: jlmi
艮: gfvn
暨: jigd
羿: yixc
翎: lkrx
翕: xirx
翥: vulx
翡: fwfx
翦: jmbx
翩: pmhx
翮: heax
翳: yikx
絷: vifx
綦: qiqx
綮: qkhx
繇: yzpx
纛: dcfx
麸: fuff
赳: jqtl
趄: jutq
趔: lptd
趑: zitr
趱: zjtr
赧: njty
赭: veto
豇: jlag
豉: iiay
酊: dkyd
酐: gjyg
酎: vzyc
酏: yiyy
酤: guyk
酢: zoyv
酡: toyb
酰: xmye
酩: mkyk
酯: viyo
酽: yjyy
酾: uiyl
酲: igyw
酴: tuyh
酹: lwyc
醌: kyyb
醅: pwyk
醐: huyo
醍: tiyr
醑: xuyo
醢: hdym
醪: lcyp
醭: buyn
醮: jnyh
醯: xiym
醵: juyu
醴: liya
醺: xyyh
豕: uian
鹾: colg
趸: dywr
踅: xtfr
蹙: cuwr
蹩: bpdr
趵: bczu
趿: tazj
趼: jmzk
趺: fuzf
跄: qlzv
跖: vizu
跗: fuzc
跚: ujzc
跞: lozl
跎: tozb
跏: jxzk
跛: bozy
跆: tdzk
跬: kvzt
跷: qnzw
跸: bizu
跣: xmze
跹: xmzz
跻: jizl
跤: jnzx
踉: llzl
跽: jizx
踔: iozu
踝: hkzg
踟: iizk
踬: vizr
踮: dmzk
踣: bozk
踯: vize
踺: jmzz
蹀: dpzm
踹: ikze
踵: vszv
踽: juzy
踱: dozy
蹉: cozg
蹁: pmzc
蹂: rzzm
蹑: npzy
蹒: pjzl
蹊: qizd
蹰: iuzc
蹶: jtzr
蹼: puzn
蹯: fjzt
蹴: cuzy
躅: vuzi
躏: lbzf
躔: ijzt
躐: lpzv
躜: zrzr
躞: xpzy
豸: vipp
貂: dnvk
貊: movb
貅: xqvm
貘: movd
貔: pivb
斛: hudu
觖: jtdg
觞: uhdp
觚: gudg
觜: zvvy
觥: gsdw
觫: sudu
觯: vidl
訾: zivk
靓: llfe
雩: yuyk
雳: liyl
雯: wfyw
霆: tkyz
霁: jiyl
霈: pwyl
霏: fwyf
霎: uayn
霪: ybyr
霭: aiyv
霰: xmyw
霾: mdyl
龀: ifvb
龃: juvq
龅: bcvs
龆: tnvk
龇: zivb
龈: ybvg
龉: yuvk
龊: iovr
龌: wovt
黾: mmkd
鼋: yred
鼍: tokd
隹: vvrf
隼: syru
隽: jyrn
雎: juqf
雒: lowf
瞿: quof
雠: izrf
銎: qsgj
銮: lrwj
鋈: wudj
錾: zjij
鍪: mzsj
鏊: aofj
鎏: lqdj
鐾: bwuj
鑫: xbjj
鱿: yzay
鲂: fhaf
鲅: baad
鲆: pkap
鲇: nmak
鲈: luau
稣: suah
鲋: fuac
鲎: hzxa
鲐: tdak
鲑: xpat
鲒: jpak
鲔: wwao
鲕: erae
鲚: jial
鲛: jnax
鲞: xlja
鲟: xyac
鲠: ggag
鲡: lial
鲢: lmaz
鲣: jmat
鲥: uiac
鲦: tnam
鲧: gyax
鲨: uada
鲩: hrae
鲫: jiae
鲭: qkao
鲮: lkaw
鲰: zzay
鲱: fwaf
鲲: kyab
鲳: ihao
鲴: guak
鲵: niae
鲶: nmax
鲷: dnak
鲺: uiai
鲻: ziat
鲼: ffar
鲽: dpam
鳄: eeak
鳅: qqah
鳇: hlaw
鳊: bmac
鳌: aofa
鳍: qiao
鳎: taax
鳏: grad
鳐: ycaf
鳓: leal
鳔: bnax
鳕: xtae
鳗: mjay
鳘: mbpa
鳙: ysal
鳜: jtar
鳝: ujak
鳟: zyac
鳢: liaa
靼: dagd
鞅: yhgy
鞑: dagz
鞒: qngl
鞔: mjgv
鞯: jmgz
鞫: jugk
鞣: rzgm
鞲: gzgr
鞴: bwgy
骱: jpgl
骰: tzgy
骷: kugk
鹘: hugn
骶: digd
骺: hzgk
骼: gegk
髁: kegg
髀: bigu
髅: lzgn
髂: qxgk
髋: krge
髌: bbgb
髑: dugi
魅: mwgw
魃: bagd
魇: yjig
魉: llgl
魈: xngo
魍: whgw
魑: iigd
飨: xlxl
餍: yjil
餮: tpdl
饕: tckl
饔: yswl
髡: kyaw
髦: mcam
髯: rjar
髫: tnak
髻: jiak
髭: ziab
髹: xqam
鬈: qrav
鬏: jqah
鬓: bbab
鬟: hray
鬣: lpav
麽: mogm
麾: hvgm
縻: migx
麂: jigj
麇: jygh
麈: vugv
麋: migm
麒: qigb
鏖: aogj
麝: uegc
麟: lbgl
黛: ddrh
黜: iuhi
黝: yzhl
黠: xxhk
黟: yihx
黢: quhw
黩: duhd
黧: lihh
黥: qkhx
黪: cjhp
黯: anho
鼢: ffjd
鼬: yzjy
鼯: wujk
鼹: yjjn
鼷: xijd
鼽: qqzj
鼾: hjzg

