丏: mmav
乂: yipn
乸: naym
亶: djwd
亸: dowl
亹: wwwq
伈: xbrx
伋: jirj
伣: qmre
伭: xmry
伾: pirp
佁: yirk
佖: birb
佢: qurj
佸: hork
佺: qrrw
佽: cirr
侁: ufre
侂: torq
侘: iarq
侴: hcrd
侹: tkrz
係: xirx
俍: llrl
俙: xirj
俤: dirp
俫: ldrl
俵: bnry
俶: tiry
倓: tjrh
倕: ivri
倞: llrx
倧: zsrx
倴: bfrc
倻: yere
偁: igrr
偓: wort
偡: vjrv
偭: mmrm
偰: xprd
偲: sirx
傃: surx
傉: nurc
傒: xird
傕: qtrf
僇: lurp
僎: vrrb
僔: zyrc
僰: boar
儦: bnrh
儳: ijrd
儴: xlry
冇: mcuk
冏: jskk
冔: xuky
冚: kjbe
冧: lbbm
冮: ghdg
凓: lidm
凘: sidj
刬: ijjd
剅: lzad
剋: kwud
剕: fwfd
剟: doyd
劄: vavd
劏: thxd
劼: jpul
勍: qkwl
勔: mmml
勚: yiul
勠: luxl
匜: yiky
匼: kekk
卌: xial
卬: yhpe
厖: mhid
厾: duvs
叆: aiey
叇: ddez
叒: royy
叕: yiyy
叚: xxvy
吔: yeky
吽: hskn
呇: qiuk
呣: omkm
呯: pkkp
咁: gjkg
咇: bikb
咉: yhky
咍: hdkk
咗: zokg
咡: erke
咥: dpkt
咺: xrkg
哃: tskk
哋: diky
哢: lskc
哱: pokz
唓: ieki
唝: gskr
唞: dzku
唵: ankd
啩: gxkb
啫: uiko
啰: lokx
啲: diku
啴: ijkl
喆: veuk
喤: hlkw
喺: xikx
嗐: hdkk
嗞: ziky
嗱: naku
嗻: vekh
嘅: gekv
嘚: dekc
嘡: thkt
嘢: yekl
嘥: sdkr
噀: xykb
噂: zykc
噃: bokt
噇: ilkl
嚄: ooky
嚚: ybkk
嚟: liku
嚡: hdkt
嚭: piuk
囧: jskv
囷: qykh
圌: ivke
圐: kukf
圙: ltkm
圢: tktd
圫: vytq
圲: qmtq
坉: tytt
坋: bftd
坒: bibt
坥: qutq
坬: gxtg
坰: jstk
坽: lkts
垈: ddrt
垍: jitz
垎: hetk
垏: lvty
垕: hzpt
垙: gltw
垚: yctt
垞: iatq
垟: yhty
垯: datz
垱: dhte
垵: antn
垺: futz
垾: hjtg
垿: xutl
埆: jtty
埇: ysty
埌: lhtl
埗: butp
埪: kstg
埫: uhtk
埵: doti
埼: qitk
堃: kyft
堉: yuto
堌: gutk
堎: lgtw
堐: yatt
堧: rrtd
堨: yetv
堲: jigt
堼: fgtt
堽: ghtv
堾: irto
塅: drty
塆: wjtg
塝: bhtf
塱: lhdt
墈: kjtl
墐: jbta
墕: yjth
墘: qmtq
墡: ujtk
墣: putn
墦: fjtt
壸: kyuy
夐: xsdw
夬: gkvn
奀: enbd
奓: vadx
奡: aoal
奭: uidb
妘: yyns
妧: yrne
妭: band
姈: lkns
姞: jink
姤: gznk
姮: hgng
姱: kxnk
姶: eenk
姽: gvnv
娀: ssnu
娵: juny
婌: uuny
婍: qink
婘: qrnv
婞: xkng
婠: wjnk
婤: vznk
婫: kynb
婳: hxnk
婻: njng
婼: ronk
媂: tinj
媄: mwnd
媆: nfnd
媓: hlnw
媖: ykny
媞: tinr
媭: xupn
媱: ycnf
嫄: yrnx
嫐: ncnn
嫕: yinx
嫚: mjny
嫪: lcnp
嫭: hunh
嫽: lnnx
嬛: xrny
嬥: tnnf
嬬: rune
嬿: yjnh
孃: nlny
孅: xmnj
孖: zizz
宧: yibi
宬: igbi
寁: zjbr
尨: phud
尪: whuw
屃: xiur
屄: biub
屌: dnuj
屼: wuew
屾: ufee
岊: jpbe
岞: zoev
岠: juej
岨: jueq
峂: tsed
峃: xtxe
峗: wwev
峘: hreg
峛: lied
峣: ycew
峧: jnex
峱: ncqe
峿: wuek
崀: lhel
崁: kjer
崄: xmea
崌: juek
崑: kyeb
崒: zueu
崚: lkew
崟: ybej
崡: hjek
崶: fgec
崿: eeek
嵁: vjev
嵅: hjek
嵎: yuey
嵖: iaed
嵚: qber
嵲: npem
嶅: aofe
嶍: xieb
嶒: cgeo
嶓: boet
嶟: zyec
嶦: vjek
嶲: jrev
巇: xieg
巉: ijed
帡: pkjk
帨: uvje
幖: bnjx
幪: mgjn
庤: vigc
庱: iggw
庼: qkgr
廆: gvgg
廋: szgy
廙: yigb
弆: jutc
弇: yjrc
弢: tcgy
弨: icgk
弶: jlgx
弸: pggo
彟: hoey
彧: yuad
徛: jiik
忞: wfwx
忳: tyxt
忺: xmxr
恓: qixx
恔: jnxx
悆: yurx
悈: kexc
悢: llxl
悰: csxx
惇: dyxz
惎: jiqx
惔: tjxh
惗: nmxx
惙: ivxy
惛: mfxo
愃: xrxg
愐: mmxm
愔: ybxo
愭: qixo
慆: tcxj
慥: zcxz
慬: qbxa
慭: yblx
憕: dgxa
憙: xiux
憭: lnxx
憺: djxk
戣: kvvg
戭: yjbg
扂: dmhk
扅: yihx
扆: yihy
扊: yjhh
扞: hjfg
扺: vifu
扽: dfft
抃: bmfb
抔: pzfb
拃: vafv
拤: qxfb
挓: vafq
挦: xmfc
捯: dcfd
捽: zofu
掞: yjfh
掟: dkfr
揕: vffv
揳: xpfd
揼: bgfu
揾: wffm
搒: pgff
搣: mpfh
摏: isfj
摛: iifd
摴: iufk
摽: bnfx
撚: nmfh
擝: mgfm
擿: vifz
攞: loff
攰: gvul
攽: bjbw
敔: yuww
敩: xtxw
斝: jxku
斠: jnju
斶: iuji
旐: vcfd
旞: svfz
旴: xuoy
旵: ijoe
旸: yhop
旻: mbow
旿: wuow
昄: bjoy
昇: ugou
昈: huoh
昉: fhof
昒: huow
昡: xroy
昣: vfop
昤: lkos
昪: bmoc
昫: xuok
昳: yiou
昺: bkob
昽: lsol
晅: xrog
晊: viot
晐: gdor
晙: jyow
晞: xioj
晢: vefo
晪: tmob
晫: voou
晱: ujoh
暅: xrog
暕: ljoj
暲: vhou
暵: hjon
暶: xror
暿: xiok
曈: tsol
曌: vcog
朏: kuoi
朓: tnod
朳: bamb
朸: liml
杄: qmmq
杕: dimd
杙: yimy
杧: mhmw
杻: izmi
枅: jimk
枍: yimv
枲: xism
枹: bcms
柈: pjmb
柊: vsmd
柖: ucmk
柷: vume
栐: ysmy
栒: xymo
栟: bfmk
栴: vjmd
栻: uimg
桯: ykmw
桲: bomz
桹: lhml
梌: tumh
梠: lvmk
梣: ifmv
梴: ijmz
梼: tcmc
梽: vimx
梾: ldml
梿: lmmz
棁: vome
棐: fwfm
棓: bwmk
棤: qtmo
棨: qihm
棪: yjmh
棫: yuma
棬: jrmv
棻: ffcm
棽: ifmv
椀: wjmv
椆: izmk
椑: bwmu
椓: vomn
椪: pgmy
椸: yimy
楒: simx
楙: mcmm
楩: pmmg
楪: yemm
楯: dymo
榃: tjmt
榅: wfmm
榑: bomc
榖: guuy
榰: vimo
槃: pjvm
槑: mwkm
槚: jxmr
槜: zvmn
槱: yzmh
橑: lnmx
橞: hvmx
橦: tsml
檞: jpmn
櫆: kvmu
欂: bomc
欸: eisr
欻: xuhr
歅: yjxr
殣: jbda
毌: wjva
毐: aiuw
氾: fjdv
氿: jqdj
汈: dndd
汋: qtdu
汧: qmdk
汫: jkdj
汭: rvdn
沄: yyds
沇: yjde
沘: bidb
沚: vidv
沨: fgdx
沺: tmdt
泂: jsdk
泃: judk
泇: jxdk
泙: pkdp
泚: cidb
泜: vidd
洈: wwdv
洑: fudq
洓: zidn
洘: kcdv
洢: yidy
洣: midm
洨: xndx
洭: kldw
洴: pkdk
洸: gldw
洺: mkdk
洿: wudv
浉: uidj
浐: ijdi
浕: jbdd
浛: hjdk
浟: didw
浡: bodz
浥: yidb
浬: lidl
浭: ggdg
浰: lidd
浲: fgdf
涄: pkdv
涍: xndz
涐: eedw
涘: sidu
涢: yydr
涴: yrdv
淏: hcdt
淜: pkdo
淟: tmdb
淯: yudo
淴: hudx
渟: tkdd
渰: yjdc
渼: mwdd
湉: tmdk
湑: xudo
湜: uidr
湝: jpdb
湣: mbdo
湲: yrdy
湴: pjdy
溁: ykdm
溇: lzdn
溍: jbdo
溚: tadk
溞: scdi
溠: vadg
溦: wwdw
溵: ybdy
溹: sodx
滃: wgdx
滆: gedl
滉: hldw
滍: vidi
滘: jndk
滧: ycdw
滪: yudr
滫: xqdo
漈: jidx
漋: lsdu
漖: jndw
漦: iiwu
漴: isdx
漷: hode
漹: yjdh
漻: lqdp
漼: cvdf
潏: yudk
潖: padb
潟: xidh
潩: yidb
潵: sjdw
潽: pudo
潾: lbdl
澂: igdw
澛: ludo
澥: xpdn
澪: lkds
澭: ysdf
澴: hrdy
澼: pidu
澽: judu
濋: iudr
濛: mgdn
濩: hudy
瀌: bndh
瀍: ijdt
瀔: gudy
瀱: jidd
瀼: rhdy
灈: qudf
炆: wfhw
炌: kdhl
炘: xbhj
炟: dahd
炣: kehk
烔: dshk
烜: xrhg
烝: vglh
烠: hvho
烶: tkhz
烺: lhhl
烻: yjhz
焆: yeho
焌: jyhw
焗: juhk
焜: kyhb
焞: tyhz
煁: ifhv
煃: kvht
煋: xkhu
煓: trhe
煟: wwho
煴: yyhm
熇: hehk
熛: bnhx
熜: cshx
熥: tghz
熻: xihx
燊: ufhm
燋: jnhh
燏: yuhk
燚: yihh
爇: roch
爔: xihd
爚: ythc
爟: grhf
牁: kepk
牂: zhpy
牚: igxy
牤: mhnw
牥: fhnf
牻: mhnd
犇: bfnn
犨: izrn
狉: piqp
〇: lkvv
狝: xmqx
猄: jkqx
猇: xnqj
猯: trqe
猰: yaqd
猺: ycqf
獴: mgqn
玃: jtqy
玒: hswg
玓: diwu
玕: gjwg
玘: qiwj
玙: yuwy
玚: yhwp
玞: fuwf
玠: jpwl
玡: yawy
玤: bhwf
玥: ytwo
玦: jtwg
玭: pbwb
玱: qlwv
玶: pkwp
玹: xmwy
玼: ciwb
玿: ucwk
珅: ufwu
珇: zuwq
珋: lqwe
珌: biwb
珒: jbwy
珕: liwl
珖: glww
珛: xqwo
珝: xuwx
珢: ybwg
珣: xywo
珦: xlwk
珪: gvwt
珫: iswe
珰: dhwe
珵: igww
珷: wuwv
珸: wuwk
珹: igwi
珺: jywk
珽: tkwz
琀: hjwk
琄: xrwo
琇: xqwn
琈: fuwz
琎: jbwz
琔: dmwr
琟: yuwf
琡: uuwy
琤: igwl
琫: bgwl
琭: luwu
琯: grwk
琲: bwwf
瑀: yuwy
瑂: mwwo
瑃: iywo
瑄: xrwg
瑅: tiwr
瑆: xkwu
瑑: vrwu
瑓: lmwj
瑔: qrwu
瑖: drwy
瑝: hlww
瑢: rswk
瑧: vfwh
瑨: jbwo
瑬: lqdy
瑱: vfwb
瑳: cowg
璆: qqwp
璈: aoww
璒: dgwa
璘: lbwl
璟: jkwx
璠: fjwt
璥: jkww
璪: zcwm
璬: jnww
璮: tjwd
璱: sewb
璲: svwz
瓀: rrwe
瓖: xlwy
瓘: grwf
瓻: iixw
甗: yjhw
甡: ufuu
甦: sugu
甪: lupy
畖: watg
畤: uitc
畬: yurt
畯: jytw
疁: lqtp
疍: djvd
疐: viur
疢: ifbh
疭: zsbr
痓: vibt
瘆: ufbp
癗: lwbt
癿: qpbv
皕: bibb
皛: xnbb
皞: hcbu
皦: jnbw
皭: jnbc
盉: hehm
盦: anrm
盷: xmod
眊: mcom
眬: lsol
睄: xnoo
睎: xioj
瞋: ifob
瞓: ffoi
瞫: ufou
瞭: lnox
矞: jtsk
矰: zguo
矻: kuuq
矼: ksug
砄: jtun
砆: fuuf
砠: juuq
砫: vuuv
砮: nunu
砵: boub
硁: kgug
硊: wwuv
硍: xmug
硔: hsub
硙: wwuj
硚: qnul
硿: ksug
碃: qkuo
碈: mbuo
碏: xiuo
碨: wwun
碶: qiud
磏: lmun
磜: qiux
磡: kjul
磹: dmuu
磻: pjut
礌: lwut
礵: uluo
祃: mapm
祇: qipu
祊: fhpf
祋: dvpy
祎: yipw
祏: uipu
祐: yzpk
祕: bipb
祲: jbpy
祼: grpg
祾: lkpw
禋: ybpt
禒: xmpu
禔: vipr
禘: dipj
禛: vfpb
禤: xrpx
秬: juhj
秾: nshn
稌: uuhh
稑: luht
稙: vihq
穄: jihx
穙: puhn
穜: vshl
穟: svhz
窅: ycbo
窊: wabg
窎: dnbn
窣: subu
窸: xibx
竑: hsls
竘: kzlk
竫: jkll
笯: nuvy
筀: gvvt
筜: dhve
筤: lhvl
筥: juvk
筦: grve
筶: gcvk
筼: yyvr
箓: luvu
箖: lbvm
篯: jmvj
簃: yivx
簉: zcvz
簕: levl
簝: lnvx
簠: fuvm
簰: pdvu
籥: ytvc
粦: lbml
粿: gomg
糒: bwmy
糵: npcm
絜: xpfx
縠: huuy
縢: tgox
繄: yikx
纮: hsss
纴: rfsr
纻: vusa
纼: vfsl
绖: dpst
绤: xisk
绹: tcsf
缊: yysm
缐: xmsu
缞: uksy
罍: lwtf
罶: lqst
罽: jisd
羑: yzyj
羓: bayb
羕: yhyy
羖: guyy
羱: yryx
翀: isxv
翂: ffxd
翃: hsux
翈: xxjx
翙: hvex
翚: hvxi
翛: xnrx
翯: hexk
翷: lbmx
翾: xrsx
耇: gzlk
耏: ndep
耑: dree
耤: jilo
耰: yzlw
肏: ccrr
肸: xiou
胈: baod
胠: quos
胣: iioy
脟: lpoc
脩: xqro
脿: bnoy
腒: juok
腘: gooy
腨: uroe
腯: tuoo
膙: jloi
臑: ncoe
臜: zaor
舠: dcvd
舥: pavb
舲: lkvs
艅: yuvh
艎: hlvw
芃: pgcf
芠: wfcw
芣: fucb
芼: mccm
苉: pice
苧: vucd
苾: bicb
茀: fucf
茋: vicd
茓: xtcb
茝: idcl
茽: vscv
荁: hrcg
荄: gdcr
荓: pkck
荖: lccb
荙: dacz
莙: jyck
莝: coct
莿: cicd
菂: dicu
菉: lucu
菍: rfcx
菼: tjch
萚: tocl
萣: dkcr
萩: qqch
萳: njcg
萹: bmcc
葎: lvcy
葖: tucq
葰: jycw
葴: vfck
蒄: grcc
蒐: szcg
蒟: juck
蒨: qmco
蒱: pucf
蒻: rocd
蓂: mkcb
蓇: guco
蓏: locg
蓢: lhco
蔀: buce
蔃: qlci
蔈: bncx
蔊: hjcg
蕗: luck
蕰: yycm
薁: yucd
薢: xpcn
薳: yrcz
薸: pncx
薿: nicr
藟: lwct
藠: jncb
藦: mocu
藨: pcch
蘘: rhcy
虒: sipj
虓: xnjj
虤: yjhj
虷: hjig
虸: ziiz
蚄: bhif
蚆: baib
蚲: pkip
蛃: bkib
蜎: yrio
蜐: jpil
蝘: yjin
蝲: laid
螠: yiim
螣: tgoi
螱: wwui
蟏: xnis
蟫: ybiu
蠋: vuii
衃: pwxb
衎: kjii
衒: xrii
衠: vyii
袆: hvpw
袗: vfpp
袪: qups
袯: bopd
裈: kypi
裛: yiwy
褕: yupd
褟: tapx
褯: jppj
襕: ljpj
襚: svpz
襜: ijpk
襫: uipb
觃: yjkz
觟: xpdt
觭: qidk
觱: biwy
觿: xidk
訄: qqjk
訚: ybmk
詟: velk
讱: rfyr
讻: xsyk
诇: xsyk
诐: biyy
谞: xuyo
谼: hsbb
谿: xipk
豨: xiuj
豮: ffur
貆: hrvg
赑: bikr
赒: vzkk
赗: fgko
赟: yywr
赪: igtr
趯: titf
跂: qizy
跐: cizb
跱: vizc
跶: dazz
踒: wozn
踦: qizk
踶: dizr
蹅: iazd
蹐: jizo
蹚: thzt
蹜: suzb
蹢: dizk
蹽: lnzx
蹾: dyzw
躝: ljzj
轪: ddid
辀: vziv
辌: llix
辒: wfim
辿: ijze
迺: ndzx
逴: iozu
遆: tizj
遹: yuzk
邘: yuye
邠: bbbe
邨: cyte
邲: bibe
邽: gvte
邿: uite
郃: here
郈: hzpe
郚: wuwe
郤: xibe
郪: qiae
郿: mwve
鄀: roce
鄃: uure
鄅: yuye
鄌: thge
鄑: ziye
鄗: hcwe
鄘: ysge
鄚: mcce
鄜: fuge
鄠: huye
鄫: zgbe
酂: zjne
酅: xiee
酦: poyd
酺: puyf
醨: liyd
醾: miym
釐: xiwl
鋆: jytj
钖: yhjp
钘: xkjk
铏: xkjd
铚: vijt
铻: wujk
锜: qijk
锧: vijr
锳: ykjy
锽: hljw
镃: zijy
镈: bojc
镋: thje
镕: rsjk
镚: bgjo
镠: lqjp
镮: hrjy
镴: lajv
镵: ijjd
闿: kdmj
阇: dumo
阘: tamx
陎: uuev
陑: eree
陞: uget
隃: yued
隩: yued
隺: hudf
雊: gzbf
雱: phyf
霅: vayk
霨: wwyc
靬: jmgg
靰: wugw
靸: sagj
靺: mogm
靽: bjgb
靿: ycgl
鞁: bwgy
鞡: lagl
鞧: qqgy
鞨: hegv
鞬: jmgz
鞮: digr
鞳: tagk
韂: ijgk
韨: fuwd
颋: tkrr
颎: jsbr
颙: ysyr
飏: yhjp
飐: vjjk
飔: sijx
飗: lqjt
饳: doui
饸: heuk
饹: geuk
饻: xiuy
馃: goug
馉: guuo
馌: yeum
馝: bihb
馞: bohz
馧: yyhm
驲: rimo
骃: ybmd
骉: bnmm
骍: xkmu
骎: qbmy
骕: sums
骙: kvmt
骦: ulmo
髃: yugy
髎: lngp
髢: diay
髽: vxat
鬒: vfab
鬘: mjay
鬶: gvfl
鬷: zsaw
魆: xugv
魋: tvgf
鱽: dcad
鱾: jiaj
鲀: tyat
鲃: baab
鲉: yzay
鲊: vaav
鲌: baab
鲏: piay
鲖: tsak
鲗: zwad
鲘: hzak
鲙: kkas
鲝: vaya
鲪: jyak
鲬: ysay
鲯: qiab
鲹: ufap
鲾: biat
鲿: ihas
鳀: tiar
鳁: wfam
鳂: wwan
鳈: qrau
鳉: jlac
鳑: phaf
鳒: jman
鳚: wwac
鳛: xiab
鳠: huay
鳡: gjax
鳣: vjad
鳤: grak
鸤: uiun
鸧: chrn
鸮: xnkn
鸰: lkrn
鸻: hgin
鸼: vzvn
鹀: wugn
鹍: kyon
鹐: qmdn
鹒: gggn
鹔: susn
鹖: heon
鹙: qqhn
鹝: yian
鹟: wgbn
鹠: lqpn
鹡: jidn
鹢: yibn
鹮: hrsn
鹯: vjwn
鹲: mgcn
鹴: ulyn
麀: yzgb
麑: nige
麖: jkgx
麹: qufm
黇: tmck
黡: yjih
鼒: zicv
鼩: qujk
鼫: uiju
鼱: jkjo
齁: hzzk
齇: vazq
齉: nhzy
龁: hevq
龂: ybvj
龢: herh
